"name[Blue Spice], eatType[coffee shop], area[city centre]"	Blue Spice is a coffee shop located in the city centre.
"name[Blue Spice], eatType[coffee shop], area[riverside]"	Blue Spice is a coffee shop in the riverside area.
"name[Blue Spice], eatType[coffee shop], customer rating[5 out of 5], near[Crowne Plaza Hotel]"	Blue Spice is a coffee shop near Crowne Plaza Hotel with a customer rating of 5 out of 5.
"name[Blue Spice], eatType[coffee shop], customer rating[average], near[Burger King]"	Blue Spice is a coffee shop near Burger King. It has an average customer rating.
"name[Blue Spice], eatType[coffee shop], customer rating[average], near[Crowne Plaza Hotel]"	Blue Spice is a coffee shop near Crowne Plaza Hotel. It has an average customer rating.
"name[Blue Spice], eatType[pub], area[city centre]"	In the city centre is a pub called Blue Spice.
"name[Blue Spice], eatType[pub], area[riverside]"	There is a pub in the riverside area called Blue Spice.
"name[Blue Spice], eatType[pub], customer rating[5 out of 5], near[Crowne Plaza Hotel]"	Blue Spice is a pub near Crowne Plaza Hotel. It has a customer rating of 5 out of 5.
"name[Blue Spice], eatType[pub], customer rating[average], near[Burger King]"	Blue Spice is a pub near Burger King with an average customer rating.
"name[Blue Spice], eatType[pub], customer rating[average], near[Crowne Plaza Hotel]"	Blue Spice is a pub near Crowne Plaza Hotel with an average customer rating.
"name[Blue Spice], eatType[pub], food[Chinese], area[city centre], familyFriendly[no], near[Rainbow Vegetarian Café]"	Blue Spice is a pub that serves chinese food. It is located in the city centre near Rainbow Vegetarian Café. It is not family friendly.
"name[Blue Spice], eatType[pub], food[Chinese], area[city centre], familyFriendly[yes], near[Rainbow Vegetarian Café]"	Blue Spice is a family friendly pub that serves chinese food. It is located in the city centre near Rainbow Vegetarian Café.
"name[Blue Spice], eatType[pub], food[Chinese], area[riverside], familyFriendly[no], near[Rainbow Vegetarian Café]"	Blue Spice is a pub that serves chinese food. It is located in the riverside area near Rainbow Vegetarian Café. It is not family friendly.
"name[Blue Spice], eatType[pub], food[Chinese], area[riverside], familyFriendly[yes], near[Rainbow Vegetarian Café]"	Blue Spice is a family friendly pub that serves chinese food. It is located in the riverside area near Rainbow Vegetarian Café.
"name[Blue Spice], eatType[pub], food[English], area[city centre], familyFriendly[no], near[Rainbow Vegetarian Café]"	Blue Spice is a pub that serves english food. It is located in the city centre near Rainbow Vegetarian Café. It is not family-friendly.
"name[Blue Spice], eatType[pub], food[English], area[city centre], familyFriendly[yes], near[Rainbow Vegetarian Café]"	Blue Spice is a family-friendly pub that serves english food. It is located in the city centre near Rainbow Vegetarian Café.
"name[Blue Spice], eatType[pub], food[English], area[riverside], familyFriendly[no], near[Rainbow Vegetarian Café]"	Blue Spice is a pub that serves english food. It is located near Rainbow Vegetarian Café in the riverside area. It is not family-friendly.
"name[Blue Spice], eatType[pub], food[English], area[riverside], familyFriendly[yes], near[Rainbow Vegetarian Café]"	Blue Spice is a family-friendly pub near Rainbow Vegetarian Café in the riverside area.
"name[Blue Spice], eatType[restaurant], food[Chinese], area[city centre], familyFriendly[no], near[Rainbow Vegetarian Café]"	Blue Spice is a chinese restaurant located in the city centre near Rainbow Vegetarian Café. It is not family friendly.
"name[Blue Spice], eatType[restaurant], food[Chinese], area[city centre], familyFriendly[yes], near[Rainbow Vegetarian Café]"	Blue Spice is a chinese restaurant in the city centre near Rainbow Vegetarian Café. It is family friendly.
"name[Blue Spice], eatType[restaurant], food[Chinese], area[riverside], familyFriendly[no], near[Rainbow Vegetarian Café]"	Blue Spice is a chinese restaurant located in the riverside area near Rainbow Vegetarian Café. It is not family friendly.
"name[Blue Spice], eatType[restaurant], food[Chinese], area[riverside], familyFriendly[yes], near[Rainbow Vegetarian Café]"	Blue Spice is a family friendly chinese restaurant located near Rainbow Vegetarian Café in the riverside area.
"name[Blue Spice], eatType[restaurant], food[English], area[city centre], familyFriendly[no], near[Rainbow Vegetarian Café]"	Blue Spice is an english restaurant located in the city centre near Rainbow Vegetarian Café. It is not family-friendly.
"name[Blue Spice], eatType[restaurant], food[English], area[city centre], familyFriendly[yes], near[Rainbow Vegetarian Café]"	Blue Spice is a family-friendly english restaurant located in the city centre near Rainbow Vegetarian Café.
"name[Blue Spice], eatType[restaurant], food[English], area[riverside], familyFriendly[no], near[Rainbow Vegetarian Café]"	Blue Spice is an english restaurant located in the riverside area near Rainbow Vegetarian Café. It is not family-friendly.
"name[Blue Spice], eatType[restaurant], food[English], area[riverside], familyFriendly[yes], near[Rainbow Vegetarian Café]"	Blue Spice is a family friendly english restaurant located near Rainbow Vegetarian Café in the riverside area.
"name[Clowns], eatType[coffee shop], customer rating[3 out of 5], near[All Bar One]"	Clowns is a coffee shop near All Bar One. It has a customer rating of 3 out of 5.
"name[Clowns], eatType[coffee shop], customer rating[5 out of 5], near[Crowne Plaza Hotel]"	Clowns is a coffee shop near Crowne Plaza Hotel with a customer rating of 5 out of 5.
"name[Clowns], eatType[coffee shop], near[The Sorrento]"	Near The Sorrento is a coffee shop called Clowns.
"name[Clowns], eatType[pub], customer rating[3 out of 5], near[All Bar One]"	Clowns is a pub near All Bar One. It has a customer rating of 3 out of 5.
"name[Clowns], eatType[pub], customer rating[5 out of 5], near[Crowne Plaza Hotel]"	Clowns is a pub near Crowne Plaza Hotel. It has a customer rating of 5 out of 5.
"name[Clowns], eatType[pub], near[The Sorrento]"	Near The Sorrento is a pub called Clowns.
"name[Cocum], eatType[coffee shop], customer rating[high], near[Burger King]"	Cocum is a coffee shop near Burger King with a high customer rating.
"name[Cocum], eatType[coffee shop], customer rating[high], near[Café Sicilia]"	Cocum is a coffee shop near Café Sicilia with a high customer rating.
"name[Cocum], eatType[coffee shop], customer rating[low], near[Café Sicilia]"	Cocum is a coffee shop near Café Sicilia with a low customer rating.
"name[Cocum], eatType[coffee shop], customer rating[low], near[Express by Holiday Inn]"	Cocum is a coffee shop near Express by Holiday Inn with a low customer rating.
"name[Cocum], eatType[coffee shop], near[The Rice Boat]"	Near The Rice Boat is a coffee shop called Cocum.
"name[Cocum], eatType[coffee shop], near[The Sorrento]"	Near The Sorrento is a coffee shop called Cocum.
"name[Cocum], eatType[pub], customer rating[high], near[Burger King]"	Cocum is a pub near Burger King with a high customer rating.
"name[Cocum], eatType[pub], customer rating[high], near[Café Sicilia]"	Cocum is a pub near Café Sicilia with a high customer rating.
"name[Cocum], eatType[pub], customer rating[low], near[Café Sicilia]"	Cocum is a pub near Café Sicilia. It has a low customer rating.
"name[Cocum], eatType[pub], customer rating[low], near[Express by Holiday Inn]"	Cocum is a pub near Express by Holiday Inn. It has a low customer rating.
"name[Cocum], eatType[pub], near[The Rice Boat]"	Near The Rice Boat is a pub called Cocum.
"name[Cocum], eatType[pub], near[The Sorrento]"	Near The Sorrento is a pub called Cocum.
"name[Cotto], eatType[coffee shop], near[The Bakers]"	Near The Bakers is a coffee shop called Cotto.
"name[Cotto], eatType[pub], near[The Bakers]"	Near The Bakers is a pub called Cotto.
"name[Giraffe], eatType[coffee shop], near[The Bakers]"	Near The Bakers is a coffee shop called Giraffe.
"name[Giraffe], eatType[coffee shop], near[The Rice Boat]"	Near The Rice Boat is a coffee shop called Giraffe.
"name[Giraffe], eatType[pub], food[English], area[riverside], familyFriendly[yes], near[Rainbow Vegetarian Café]"	Giraffe is a family-friendly pub near Rainbow Vegetarian Café in the riverside area.
"name[Giraffe], eatType[pub], food[Fast food], area[city centre], familyFriendly[no], near[Rainbow Vegetarian Café]"	Giraffe is a pub that serves fast food. It is located in the city centre near Rainbow Vegetarian Café. It is not family-friendly.
"name[Giraffe], eatType[pub], food[Fast food], area[city centre], familyFriendly[yes], near[Rainbow Vegetarian Café]"	Giraffe is a family-friendly pub that serves fast food. It is located in the city centre near Rainbow Vegetarian Café.
"name[Giraffe], eatType[pub], food[Fast food], area[riverside], familyFriendly[no], near[Rainbow Vegetarian Café]"	Giraffe is a fast food pub in the riverside area near Rainbow Vegetarian Café. It is not family-friendly.
"name[Giraffe], eatType[pub], food[Fast food], area[riverside], familyFriendly[yes], near[Rainbow Vegetarian Café]"	Giraffe is a family friendly pub that serves fast food. It is located in the riverside area near Rainbow Vegetarian Café.
"name[Giraffe], eatType[pub], food[Fast food], area[riverside], familyFriendly[yes], near[Raja Indian Cuisine]"	Giraffe is a family friendly pub that serves fast food. It is located in the riverside area near Raja Indian Cuisine.
"name[Giraffe], eatType[pub], food[French], area[city centre], familyFriendly[no], near[Raja Indian Cuisine]"	Giraffe is a pub that serves french food. It is located in the city centre near Raja Indian Cuisine. It is not family-friendly.
"name[Giraffe], eatType[pub], food[French], area[city centre], familyFriendly[yes], near[Raja Indian Cuisine]"	Giraffe is a family-friendly pub that serves french food. It is located in the city centre near Raja Indian Cuisine.
"name[Giraffe], eatType[pub], food[French], area[riverside], familyFriendly[no], near[Raja Indian Cuisine]"	Giraffe is a pub that serves french food. It is located near Raja Indian Cuisine in the riverside area. It is not family-friendly.
"name[Giraffe], eatType[pub], food[French], area[riverside], familyFriendly[yes], near[Raja Indian Cuisine]"	Giraffe is a family-friendly pub that serves french food. It is located in the riverside area near Raja Indian Cuisine.
"name[Giraffe], eatType[pub], near[The Bakers]"	Near The Bakers is a pub called Giraffe.
"name[Giraffe], eatType[pub], near[The Rice Boat]"	Near The Rice Boat is a pub called Giraffe.
"name[Giraffe], eatType[restaurant], food[English], area[riverside], familyFriendly[yes], near[Rainbow Vegetarian Café]"	Giraffe is a family friendly english restaurant located near Rainbow Vegetarian Café in the riverside area.
"name[Giraffe], eatType[restaurant], food[Fast food], area[city centre], familyFriendly[no], near[Rainbow Vegetarian Café]"	Giraffe is located in the city centre near Rainbow Vegetarian Café. It is not family-friendly and serves fast food.
"name[Giraffe], eatType[restaurant], food[Fast food], area[city centre], familyFriendly[yes], near[Rainbow Vegetarian Café]"	Giraffe is a family-friendly fast food restaurant located in the city centre near Rainbow Vegetarian Café.
"name[Giraffe], eatType[restaurant], food[Fast food], area[riverside], familyFriendly[no], near[Rainbow Vegetarian Café]"	Giraffe is a fast food restaurant located in the riverside area near Rainbow Vegetarian Café. It is not family-friendly.
"name[Giraffe], eatType[restaurant], food[Fast food], area[riverside], familyFriendly[yes], near[Rainbow Vegetarian Café]"	Giraffe is a fast food restaurant in the riverside area near Rainbow Vegetarian Café. It is family friendly.
"name[Giraffe], eatType[restaurant], food[Fast food], area[riverside], familyFriendly[yes], near[Raja Indian Cuisine]"	Giraffe is a fast food restaurant in the riverside area near Raja Indian Cuisine. It is family friendly.
"name[Giraffe], eatType[restaurant], food[French], area[city centre], familyFriendly[no], near[Raja Indian Cuisine]"	Giraffe is located in the city centre near Raja Indian Cuisine. It is not family-friendly and serves french food.
"name[Giraffe], eatType[restaurant], food[French], area[city centre], familyFriendly[yes], near[Raja Indian Cuisine]"	Giraffe is a family-friendly french restaurant located in the city centre near Raja Indian Cuisine.
"name[Giraffe], eatType[restaurant], food[French], area[riverside], familyFriendly[no], near[Raja Indian Cuisine]"	Giraffe is a french restaurant located in the riverside area near Raja Indian Cuisine. It is not family-friendly.
"name[Giraffe], eatType[restaurant], food[French], area[riverside], familyFriendly[yes], near[Raja Indian Cuisine]"	Giraffe is a family friendly french restaurant located near Raja Indian Cuisine in the riverside area.
"name[Green Man], eatType[coffee shop], customer rating[1 out of 5], near[All Bar One]"	Green Man is a coffee shop near All Bar One. It has a customer rating of 1 out of 5.
"name[Green Man], eatType[coffee shop], customer rating[3 out of 5], near[All Bar One]"	Green Man is a coffee shop near All Bar One. It has a customer rating of 3 out of 5.
"name[Green Man], eatType[pub], customer rating[1 out of 5], near[All Bar One]"	Green Man is a pub near All Bar One. It has a customer rating of 1 out of 5.
"name[Green Man], eatType[pub], customer rating[3 out of 5], near[All Bar One]"	Green Man is a pub near All Bar One. It has a customer rating of 3 out of 5.
"name[Green Man], eatType[pub], food[Italian], area[riverside], familyFriendly[yes], near[Express by Holiday Inn]"	Green Man is a family-friendly pub near Express by Holiday Inn in the riverside area.
"name[Green Man], eatType[pub], food[Italian], area[riverside], familyFriendly[yes], near[Raja Indian Cuisine]"	Green Man is a family-friendly pub near Raja Indian Cuisine in the riverside area.
"name[Green Man], eatType[pub], food[Japanese], area[city centre], familyFriendly[no], near[Express by Holiday Inn]"	Green Man is a pub that serves japanese food. It is located in the city centre near Express by Holiday Inn. It is not family-friendly.
"name[Green Man], eatType[pub], food[Japanese], area[city centre], familyFriendly[yes], near[Express by Holiday Inn]"	Green Man is a family-friendly pub that serves japanese food. It is located in the city centre near Express by Holiday Inn.
"name[Green Man], eatType[pub], food[Japanese], area[riverside], familyFriendly[no], near[Express by Holiday Inn]"	Green Man is a pub that serves japanese food. It is located near Express by Holiday Inn in the riverside area. It is not family-friendly.
"name[Green Man], eatType[pub], food[Japanese], area[riverside], familyFriendly[yes], near[Express by Holiday Inn]"	Green Man is a family-friendly pub that serves japanese food. It is located near Express by Holiday Inn in the riverside area.
"name[Green Man], eatType[restaurant], food[Italian], area[riverside], familyFriendly[yes], near[Express by Holiday Inn]"	Green Man is a family-friendly italian restaurant located near Express by Holiday Inn in the riverside area.
"name[Green Man], eatType[restaurant], food[Italian], area[riverside], familyFriendly[yes], near[Raja Indian Cuisine]"	Green Man is a family-friendly italian restaurant located near Raja Indian Cuisine in the riverside area.
"name[Green Man], eatType[restaurant], food[Japanese], area[city centre], familyFriendly[no], near[Express by Holiday Inn]"	Green Man is a family-friendly japanese restaurant located in the city centre near Express by Holiday Inn.
"name[Green Man], eatType[restaurant], food[Japanese], area[city centre], familyFriendly[yes], near[Express by Holiday Inn]"	Green Man is a family-friendly japanese restaurant located in the city centre near Express by Holiday Inn.
"name[Green Man], eatType[restaurant], food[Japanese], area[riverside], familyFriendly[no], near[Express by Holiday Inn]"	Green Man is a japanese restaurant located in the riverside area near Express by Holiday Inn. It is not family-friendly.
"name[Green Man], eatType[restaurant], food[Japanese], area[riverside], familyFriendly[yes], near[Express by Holiday Inn]"	Green Man is a family friendly japanese restaurant located near Express by Holiday Inn in the riverside area.
"name[Loch Fyne], eatType[coffee shop], area[riverside]"	Loch Fyne is a coffee shop in the riverside area.
"name[Loch Fyne], eatType[pub], area[riverside]"	There is a pub in the riverside area called Loch Fyne.
"name[Strada], eatType[coffee shop], area[city centre]"	Strada is a coffee shop located in the city centre.
"name[Strada], eatType[coffee shop], customer rating[1 out of 5], near[All Bar One]"	Strada is a coffee shop near All Bar One. It has a customer rating of 1 out of 5.
"name[Strada], eatType[coffee shop], customer rating[1 out of 5], near[Rainbow Vegetarian Café]"	Strada is a coffee shop near Rainbow Vegetarian Café. It has a customer rating of 1 out of 5.
"name[Strada], eatType[coffee shop], customer rating[low], near[Express by Holiday Inn]"	Strada is a coffee shop near Express by Holiday Inn with a low customer rating.
"name[Strada], eatType[pub], area[city centre]"	In the city centre is a pub called Strada.
"name[Strada], eatType[pub], customer rating[1 out of 5], near[All Bar One]"	Strada is a pub near All Bar One. It has a customer rating of 1 out of 5.
"name[Strada], eatType[pub], customer rating[1 out of 5], near[Rainbow Vegetarian Café]"	Strada is a pub near Rainbow Vegetarian Café. It has a customer rating of 1 out of 5.
"name[Strada], eatType[pub], customer rating[low], near[Express by Holiday Inn]"	Strada is a pub near Express by Holiday Inn. It has a low customer rating.
"name[The Cricketers], eatType[coffee shop], customer rating[1 out of 5], familyFriendly[yes], near[Avalon]"	The Cricketers is a coffee shop near Avalon. It is kid friendly and has a customer rating of 1 out of 5.
"name[The Cricketers], eatType[coffee shop], customer rating[3 out of 5], familyFriendly[yes], near[Avalon]"	The Cricketers is a coffee shop near Avalon. It is kid friendly and has a customer rating of 3 out of 5.
"name[The Cricketers], eatType[coffee shop], customer rating[3 out of 5], familyFriendly[yes], near[Crowne Plaza Hotel]"	The Cricketers is a coffee shop near Crowne Plaza Hotel. It is kid friendly and has a customer rating of 3 out of 5.
"name[The Cricketers], eatType[coffee shop], customer rating[5 out of 5], familyFriendly[no], near[Crowne Plaza Hotel]"	The Cricketers is a coffee shop near Crowne Plaza Hotel. It is not family-friendly and has a customer rating of 5 out of 5.
"name[The Cricketers], eatType[coffee shop], customer rating[5 out of 5], familyFriendly[yes], near[Crowne Plaza Hotel]"	The Cricketers is a coffee shop near Crowne Plaza Hotel. It is family friendly and has a customer rating of 5 out of 5.
"name[The Cricketers], eatType[coffee shop], customer rating[average], familyFriendly[no], near[Café Sicilia]"	The Cricketers is a coffee shop near Café Sicilia. It is not family-friendly and has an average customer rating.
"name[The Cricketers], eatType[coffee shop], customer rating[average], familyFriendly[no], near[Crowne Plaza Hotel]"	The Cricketers is a coffee shop near Crowne Plaza Hotel. It is not family-friendly and has an average customer rating.
"name[The Cricketers], eatType[coffee shop], customer rating[average], familyFriendly[yes], near[Café Sicilia]"	The Cricketers is a coffee shop near Café Sicilia. It is family friendly and has an average customer rating.
"name[The Cricketers], eatType[coffee shop], customer rating[high], familyFriendly[yes], near[Café Sicilia]"	The Cricketers is a coffee shop near Café Sicilia. It is child friendly and has a high customer rating.
"name[The Cricketers], eatType[coffee shop], customer rating[high], familyFriendly[yes], near[Express by Holiday Inn]"	The Cricketers is a coffee shop near Express by Holiday Inn. It is child friendly and has a high customer rating.
"name[The Cricketers], eatType[coffee shop], customer rating[low], familyFriendly[no], near[Express by Holiday Inn]"	The Cricketers is a coffee shop near Express by Holiday Inn. It is not family-friendly and has a low customer rating.
"name[The Cricketers], eatType[coffee shop], customer rating[low], familyFriendly[no], near[Ranch]"	The Cricketers is a coffee shop near Ranch. It is not family-friendly and has a low customer rating.
"name[The Cricketers], eatType[coffee shop], customer rating[low], familyFriendly[yes], near[Ranch]"	The Cricketers is a family friendly coffee shop located near Ranch. It has a low customer rating.
"name[The Cricketers], eatType[restaurant], customer rating[1 out of 5], familyFriendly[yes], near[Avalon]"	The Cricketers is a child friendly restaurant near Avalon. It has a customer rating of 1 out of 5.
"name[The Cricketers], eatType[restaurant], customer rating[3 out of 5], familyFriendly[yes], near[Avalon]"	The Cricketers is a kid friendly restaurant with a customer rating of 3 out of 5. It is located near Avalon.
"name[The Cricketers], eatType[restaurant], customer rating[3 out of 5], familyFriendly[yes], near[Crowne Plaza Hotel]"	The Cricketers is a kid friendly restaurant with a customer rating of 3 out of 5. It is located near Crowne Plaza Hotel.
"name[The Cricketers], eatType[restaurant], customer rating[5 out of 5], familyFriendly[no], near[Crowne Plaza Hotel]"	The Cricketers is a restaurant near the Crowne Plaza Hotel. It is not family-friendly and has a customer rating of 5 out of 5.
"name[The Cricketers], eatType[restaurant], customer rating[5 out of 5], familyFriendly[yes], near[Crowne Plaza Hotel]"	The Cricketers is a restaurant near Crowne Plaza Hotel. It is family friendly and has a customer rating of 5 out of 5.
"name[The Cricketers], eatType[restaurant], customer rating[average], familyFriendly[no], near[Café Sicilia]"	The Cricketers is a restaurant near Café Sicilia. It is not family-friendly and has an average customer rating.
"name[The Cricketers], eatType[restaurant], customer rating[average], familyFriendly[no], near[Crowne Plaza Hotel]"	The Cricketers is a restaurant near Crowne Plaza Hotel. It is not family-friendly and has an average customer rating.
"name[The Cricketers], eatType[restaurant], customer rating[average], familyFriendly[yes], near[Café Sicilia]"	The Cricketers is a restaurant near Café Sicilia. It is family friendly and has an average customer rating.
"name[The Cricketers], eatType[restaurant], customer rating[high], familyFriendly[yes], near[Café Sicilia]"	The Cricketers is a child friendly restaurant near Café Sicilia. It has a high customer rating.
"name[The Cricketers], eatType[restaurant], customer rating[high], familyFriendly[yes], near[Express by Holiday Inn]"	The Cricketers is a child friendly restaurant near Express by Holiday Inn. It has a high customer rating.
"name[The Cricketers], eatType[restaurant], customer rating[low], familyFriendly[no], near[Express by Holiday Inn]"	The Cricketers is a restaurant near Express by Holiday Inn. It is not family-friendly and has a low customer rating.
"name[The Cricketers], eatType[restaurant], customer rating[low], familyFriendly[no], near[Ranch]"	The Cricketers is a restaurant near Ranch. It is not family-friendly and has a low customer rating.
"name[The Cricketers], eatType[restaurant], customer rating[low], familyFriendly[yes], near[Ranch]"	The Cricketers is a family-friendly restaurant near Ranch. It has a low customer rating.
"name[The Cricketers], eatType[restaurant], food[Chinese], priceRange[£20-25], customer rating[high], area[city centre], familyFriendly[no], near[All Bar One]"	The Cricketers is a chinese restaurant located in the city centre near All Bar One. It has a high customer rating and is not kid friendly and has a price range of £20-25.
"name[The Cricketers], eatType[restaurant], food[Chinese], priceRange[£20-25], customer rating[high], area[city centre], familyFriendly[yes], near[All Bar One]"	The Cricketers is a chinese restaurant in the city centre near All Bar One. It has a high customer rating and a price range of £20-25 and is kid friendly.
"name[The Cricketers], eatType[restaurant], food[Chinese], priceRange[£20-25], customer rating[high], area[riverside], familyFriendly[no], near[All Bar One]"	The Cricketers is a chinese restaurant located near All Bar One in the riverside area. It has a high customer rating and a price range of £20-25 and is not kid friendly.
"name[The Cricketers], eatType[restaurant], food[Chinese], priceRange[£20-25], customer rating[high], area[riverside], familyFriendly[yes], near[All Bar One]"	The Cricketers is a chinese restaurant with a high customer rating. It is located in the riverside area near All Bar One. It is kid friendly and has a price range of £20-25.
"name[The Cricketers], eatType[restaurant], food[Chinese], priceRange[cheap], customer rating[5 out of 5], area[city centre], familyFriendly[no], near[All Bar One]"	The Cricketers is a cheap chinese restaurant in the city centre near All Bar One. It has a customer rating of 5 out of 5 and is not family-friendly.
"name[The Cricketers], eatType[restaurant], food[Chinese], priceRange[cheap], customer rating[5 out of 5], area[city centre], familyFriendly[yes], near[All Bar One]"	The Cricketers is a cheap chinese restaurant in the city centre near All Bar One. It is family friendly and has a customer rating of 5 out of 5.
"name[The Cricketers], eatType[restaurant], food[Chinese], priceRange[cheap], customer rating[5 out of 5], area[riverside], familyFriendly[no], near[All Bar One]"	The Cricketers is a cheap chinese restaurant in the riverside area near All Bar One. It has a customer rating of 5 out of 5 and is not family-friendly.
"name[The Cricketers], eatType[restaurant], food[Chinese], priceRange[cheap], customer rating[5 out of 5], area[riverside], familyFriendly[yes], near[All Bar One]"	The Cricketers is a chinese restaurant with a 5 out of 5 rating. It is located near All Bar One in the riverside area. It is family friendly and has a cheap price range.
"name[The Cricketers], eatType[restaurant], food[Chinese], priceRange[cheap], customer rating[average], area[city centre], familyFriendly[no], near[All Bar One]"	The Cricketers is a cheap chinese restaurant in the city centre near All Bar One. It is not family-friendly and has an average customer rating.
"name[The Cricketers], eatType[restaurant], food[Chinese], priceRange[cheap], customer rating[average], area[city centre], familyFriendly[yes], near[All Bar One]"	The Cricketers is a family friendly chinese restaurant in the city centre near All Bar One. It has an average customer rating and a cheap price range.
"name[The Cricketers], eatType[restaurant], food[Chinese], priceRange[cheap], customer rating[average], area[riverside], familyFriendly[no], near[All Bar One]"	The Cricketers is a cheap chinese restaurant near All Bar One in the riverside area. It has an average customer rating and is not family friendly.
"name[The Cricketers], eatType[restaurant], food[Chinese], priceRange[cheap], customer rating[average], area[riverside], familyFriendly[yes], near[All Bar One]"	The Cricketers is a cheap chinese restaurant near All Bar One in the riverside area. It is family friendly and has an average customer rating.
"name[The Cricketers], eatType[restaurant], food[Chinese], priceRange[high], customer rating[1 out of 5], area[city centre], familyFriendly[no], near[All Bar One]"	The Cricketers provides chinese food in the high price range. It is located in the city centre near All Bar One. Its customer rating is 1 out of 5.
"name[The Cricketers], eatType[restaurant], food[Chinese], priceRange[high], customer rating[1 out of 5], area[city centre], familyFriendly[yes], near[All Bar One]"	The Cricketers provides chinese food in the high price range. It is located in the city centre near All Bar One. Its customer rating is 1 out of 5.
"name[The Cricketers], eatType[restaurant], food[Chinese], priceRange[high], customer rating[1 out of 5], area[riverside], familyFriendly[no], near[All Bar One]"	The Cricketers is a chinese restaurant located near All Bar One in the riverside area. It is not child friendly and has a customer rating of 1 out of 5.
"name[The Cricketers], eatType[restaurant], food[Chinese], priceRange[high], customer rating[1 out of 5], area[riverside], familyFriendly[yes], near[All Bar One]"	The Cricketers is a chinese restaurant located near All Bar One in the riverside area. It is child friendly and has a high price range and a customer rating of 1 out of 5.
"name[The Cricketers], eatType[restaurant], food[Chinese], priceRange[high], customer rating[average], area[city centre], familyFriendly[no], near[All Bar One]"	The Cricketers is a chinese restaurant located in the city centre near All Bar One. It is not child friendly and has an average customer rating.
"name[The Cricketers], eatType[restaurant], food[Chinese], priceRange[high], customer rating[average], area[city centre], familyFriendly[yes], near[All Bar One]"	The Cricketers is a chinese restaurant located in the city centre near All Bar One. It is child friendly and has an average customer rating and a high price range.
"name[The Cricketers], eatType[restaurant], food[Chinese], priceRange[high], customer rating[average], area[riverside], familyFriendly[no], near[All Bar One]"	The Cricketers is a chinese restaurant located near All Bar One in the riverside area. It is not child friendly and has an average customer rating.
"name[The Cricketers], eatType[restaurant], food[Chinese], priceRange[high], customer rating[average], area[riverside], familyFriendly[yes], near[All Bar One]"	The Cricketers is a chinese restaurant near All Bar One in the riverside area. It is child friendly and has an average customer rating and a high price range.
"name[The Cricketers], eatType[restaurant], food[Chinese], priceRange[less than £20], customer rating[low], area[city centre], familyFriendly[no], near[All Bar One]"	The Cricketers is a chinese restaurant in the city centre near All Bar One. It has a low customer rating and is not family-friendly and has a price range of less than £20.
"name[The Cricketers], eatType[restaurant], food[Chinese], priceRange[less than £20], customer rating[low], area[city centre], familyFriendly[yes], near[All Bar One]"	The Cricketers is a chinese restaurant with a price range of less than £20. It is located in the city centre near All Bar One. It is family-friendly and has a low customer rating.
"name[The Cricketers], eatType[restaurant], food[Chinese], priceRange[less than £20], customer rating[low], area[riverside], familyFriendly[no], near[All Bar One]"	The Cricketers is a chinese restaurant with a price range less than £20. It is located in the riverside. It is near All Bar One. It is not family friendly and has a low customer rating.
"name[The Cricketers], eatType[restaurant], food[Chinese], priceRange[less than £20], customer rating[low], area[riverside], familyFriendly[yes], near[All Bar One]"	The Cricketers is a chinese restaurant with a price range less than £20. It is located in the riverside. It is near All Bar One. It is family friendly and has a low customer rating.
"name[The Cricketers], eatType[restaurant], food[Chinese], priceRange[moderate], customer rating[1 out of 5], area[city centre], familyFriendly[no], near[All Bar One]"	The Cricketers is a chinese restaurant located in the city centre near All Bar One. It is not kid friendly and has a customer rating of 1 out of 5.
"name[The Cricketers], eatType[restaurant], food[Chinese], priceRange[moderate], customer rating[1 out of 5], area[city centre], familyFriendly[yes], near[All Bar One]"	"The Cricketers is a chinese restaurant with a moderate price range. It is located in the city centre, near All Bar One. It is kid friendly and has a customer rating of 1 out of 5."
"name[The Cricketers], eatType[restaurant], food[Chinese], priceRange[moderate], customer rating[1 out of 5], area[riverside], familyFriendly[no], near[All Bar One]"	The Cricketers is a chinese restaurant located near All Bar One in the riverside area. It is not kid friendly and has a customer rating of 1 out of 5 and is moderately priced.
"name[The Cricketers], eatType[restaurant], food[Chinese], priceRange[moderate], customer rating[1 out of 5], area[riverside], familyFriendly[yes], near[All Bar One]"	The Cricketers is a chinese restaurant with a moderate price range. It is located in the riverside area near All Bar One. It is kid friendly and has a customer rating of 1 out of 5.
"name[The Cricketers], eatType[restaurant], food[Chinese], priceRange[moderate], customer rating[3 out of 5], area[city centre], familyFriendly[no], near[All Bar One]"	The Cricketers is a chinese restaurant located in the city centre near All Bar One. It is moderately priced and has a customer rating of 3 out of 5. It is not kid friendly.
"name[The Cricketers], eatType[restaurant], food[Chinese], priceRange[moderate], customer rating[3 out of 5], area[city centre], familyFriendly[yes], near[All Bar One]"	The Cricketers is a chinese restaurant with a moderate price range. It is located in the city centre near All Bar One. It is kid friendly and has a customer rating of 3 out of 5.
"name[The Cricketers], eatType[restaurant], food[Chinese], priceRange[moderate], customer rating[3 out of 5], area[riverside], familyFriendly[no], near[All Bar One]"	The Cricketers is a chinese restaurant with a moderate price range. It is located in the riverside area near All Bar One. It is not kid friendly and has a customer rating of 3 out of 5.
"name[The Cricketers], eatType[restaurant], food[Chinese], priceRange[moderate], customer rating[3 out of 5], area[riverside], familyFriendly[yes], near[All Bar One]"	The Cricketers is a chinese restaurant with a moderate price range. It is located in the riverside area near All Bar One. It is kid friendly and has a customer rating of 3 out of 5.
"name[The Cricketers], eatType[restaurant], food[Chinese], priceRange[more than £30], customer rating[high], area[city centre], familyFriendly[no], near[All Bar One]"	The Cricketers is a chinese restaurant located in the city centre near All Bar One. It has a high customer rating and a price range of more than £30. It is not child friendly.
"name[The Cricketers], eatType[restaurant], food[Chinese], priceRange[more than £30], customer rating[high], area[city centre], familyFriendly[yes], near[All Bar One]"	The Cricketers is a chinese restaurant located in the city centre near All Bar One. It has a high customer rating and is child friendly. The price range is more than £30.
"name[The Cricketers], eatType[restaurant], food[Chinese], priceRange[more than £30], customer rating[high], area[riverside], familyFriendly[no], near[All Bar One]"	The Cricketers is a chinese restaurant located near All Bar One in the riverside area. It has a high customer rating and is not child friendly and has a price range of more than £30.
"name[The Cricketers], eatType[restaurant], food[Chinese], priceRange[more than £30], customer rating[high], area[riverside], familyFriendly[yes], near[All Bar One]"	The Cricketers is a chinese restaurant located near All Bar One in the riverside area. It is child friendly and has a high customer rating and a price range of more than £30.
"name[The Cricketers], eatType[restaurant], food[English], priceRange[£20-25], customer rating[high], area[city centre], familyFriendly[no], near[All Bar One]"	The Cricketers is an english restaurant located in the city centre near All Bar One. It has a high customer rating and a price range of £20-25 and is not kid friendly.
"name[The Cricketers], eatType[restaurant], food[English], priceRange[£20-25], customer rating[high], area[city centre], familyFriendly[yes], near[All Bar One]"	The Cricketers is a highly rated english restaurant in the city centre near All Bar One. It is kid friendly and has a price range of £20-25.
"name[The Cricketers], eatType[restaurant], food[English], priceRange[£20-25], customer rating[high], area[riverside], familyFriendly[no], near[All Bar One]"	"The Cricketers is a highly rated, english restaurant near All Bar One in the riverside area. It is not kid friendly and has a price range of £20-25."
"name[The Cricketers], eatType[restaurant], food[English], priceRange[£20-25], customer rating[high], area[riverside], familyFriendly[yes], near[All Bar One]"	"The Cricketers is a highly rated, kid friendly, english restaurant, located near All Bar One in the riverside area. The price range is £20-25."
"name[The Cricketers], eatType[restaurant], food[English], priceRange[cheap], customer rating[5 out of 5], area[city centre], familyFriendly[no], near[Café Rouge]"	The Cricketers is a cheap english restaurant in the city centre near Café Rouge. It has a customer rating of 5 out of 5 and is not family-friendly.
"name[The Cricketers], eatType[restaurant], food[English], priceRange[cheap], customer rating[5 out of 5], area[city centre], familyFriendly[yes], near[Café Rouge]"	The Cricketers is a family-friendly english restaurant located near Café Rouge in the city centre. It has a customer rating of 5 out of 5 and a cheap price range.
"name[The Cricketers], eatType[restaurant], food[English], priceRange[cheap], customer rating[5 out of 5], area[riverside], familyFriendly[no], near[Café Rouge]"	The Cricketers is an english restaurant near Café Rouge in the riverside area. It has a customer rating of 5 out of 5. It is not family-friendly and has a cheap price range.
"name[The Cricketers], eatType[restaurant], food[English], priceRange[cheap], customer rating[5 out of 5], area[riverside], familyFriendly[yes], near[Café Rouge]"	The Cricketers is a family friendly restaurant located near Café Rouge. It serves english food. It has a customer rating of 5 out of 5 and is cheap.
"name[The Cricketers], eatType[restaurant], food[English], priceRange[cheap], customer rating[average], area[city centre], familyFriendly[no], near[Café Rouge]"	The Cricketers is an english restaurant located near Café Rouge in the city centre. It is not family-friendly and has an average customer rating.
"name[The Cricketers], eatType[restaurant], food[English], priceRange[cheap], customer rating[average], area[city centre], familyFriendly[yes], near[Café Rouge]"	The Cricketers is a family-friendly english restaurant located near Café Rouge in the city centre. It has an average customer rating and a cheap price range.
"name[The Cricketers], eatType[restaurant], food[English], priceRange[cheap], customer rating[average], area[riverside], familyFriendly[no], near[Café Rouge]"	The Cricketers is an english restaurant located near Café Rouge in the riverside area. It is not family-friendly and has an average customer rating.
"name[The Cricketers], eatType[restaurant], food[English], priceRange[cheap], customer rating[average], area[riverside], familyFriendly[yes], near[Café Rouge]"	The Cricketers is a family-friendly restaurant located near Café Rouge. It serves english food and has an average customer rating. It is cheap.
"name[The Cricketers], eatType[restaurant], food[English], priceRange[high], customer rating[1 out of 5], area[city centre], familyFriendly[no], near[Café Rouge]"	The Cricketers is an english restaurant located in the city centre near Café Rouge. It is not child friendly and has a customer rating of 1 out of 5.
"name[The Cricketers], eatType[restaurant], food[English], priceRange[high], customer rating[1 out of 5], area[city centre], familyFriendly[yes], near[Café Rouge]"	The Cricketers is an english restaurant located near Café Rouge in the city centre. It has a customer rating of 1 out of 5. It is child friendly and has a high price range.
"name[The Cricketers], eatType[restaurant], food[English], priceRange[high], customer rating[1 out of 5], area[riverside], familyFriendly[no], near[Café Rouge]"	The Cricketers is an expensive restaurant located near Café Rouge in the riverside area. It serves english food. It has a customer rating of 1 out of 5 and is not child friendly.
"name[The Cricketers], eatType[restaurant], food[English], priceRange[high], customer rating[1 out of 5], area[riverside], familyFriendly[yes], near[Café Rouge]"	The Cricketers is a child-friendly restaurant located near Café Rouge in the riverside area. It serves english food and has a customer rating of 1 out of 5.
"name[The Cricketers], eatType[restaurant], food[English], priceRange[high], customer rating[average], area[city centre], familyFriendly[no], near[Café Rouge]"	The Cricketers is an english restaurant located in the city centre near the Café Rouge. It is not child friendly and has an average customer rating.
"name[The Cricketers], eatType[restaurant], food[English], priceRange[high], customer rating[average], area[city centre], familyFriendly[yes], near[Café Rouge]"	The Cricketers is an english restaurant near Café Rouge in the city centre. It is child friendly and has an average customer rating and a high price range.
"name[The Cricketers], eatType[restaurant], food[English], priceRange[high], customer rating[average], area[riverside], familyFriendly[no], near[Café Rouge]"	The Cricketers is an expensive restaurant located near Café Rouge. It is not family-friendly and has an average customer rating.
"name[The Mill], eatType[pub], food[English], priceRange[high], area[riverside], familyFriendly[yes], near[Raja Indian Cuisine]"	The Mill is a high-priced pub in the riverside area near Raja Indian Cuisine. It serves english food and is child friendly.
"name[The Mill], eatType[pub], food[English], priceRange[less than £20], area[city centre], familyFriendly[no], near[Raja Indian Cuisine]"	The Mill is an english pub near Raja Indian Cuisine in the city centre. It is not family-friendly and has a price range of less than £20.
"name[The Mill], eatType[pub], food[English], priceRange[less than £20], area[city centre], familyFriendly[yes], near[Raja Indian Cuisine]"	The Mill is a family-friendly pub located near Raja Indian Cuisine in the city centre. It serves english food for less than £20.
"name[The Mill], eatType[pub], food[English], priceRange[less than £20], area[riverside], familyFriendly[no], near[Raja Indian Cuisine]"	The Mill is an english pub near Raja Indian Cuisine in the riverside area. It is not family-friendly and has a price range of less than £20.
"name[The Mill], eatType[pub], food[English], priceRange[less than £20], area[riverside], familyFriendly[yes], near[Raja Indian Cuisine]"	The Mill is a family-friendly pub near Raja Indian Cuisine. It serves english food for less than £20. It is located in the riverside area.
"name[The Mill], eatType[pub], food[English], priceRange[moderate], area[city centre], familyFriendly[no], near[Raja Indian Cuisine]"	The Mill is a pub that serves english food. It is located in the city centre near Raja Indian Cuisine. It is not kid friendly and has a moderate price range.
"name[The Mill], eatType[pub], food[English], priceRange[moderate], area[city centre], familyFriendly[yes], near[Raja Indian Cuisine]"	The Mill is a pub that serves english food. It is located near Raja Indian Cuisine in the city centre. It is kid friendly and has a moderate price range.
"name[The Mill], eatType[pub], food[English], priceRange[moderate], area[riverside], familyFriendly[no], near[Raja Indian Cuisine]"	The Mill is a pub that serves english food. It is located near Raja Indian Cuisine in the riverside area. It is not kid friendly and has a moderate price range.
"name[The Mill], eatType[pub], food[English], priceRange[moderate], area[riverside], familyFriendly[yes], near[Raja Indian Cuisine]"	The Mill is a pub that serves english food. It is located near Raja Indian Cuisine in the riverside area. It is kid friendly and has a moderate price range.
"name[The Mill], eatType[pub], food[English], priceRange[more than £30], area[riverside], familyFriendly[yes], near[Raja Indian Cuisine]"	The Mill is a pub that serves english food. It is located near Raja Indian Cuisine in the riverside area. It is child friendly and has a price range of more than £30.
"name[The Mill], eatType[pub], food[Fast food], priceRange[£20-25], area[riverside], familyFriendly[yes], near[Raja Indian Cuisine]"	The Mill is a kid friendly pub that serves fast food. It is located near Raja Indian Cuisine in the riverside area and has a price range of £20-25.
"name[The Mill], eatType[pub], food[Fast food], priceRange[£20-25], customer rating[high], area[city centre], familyFriendly[no], near[Café Rouge]"	The Mill is a fast food pub in the city centre near Café Rouge. It is not kid friendly and has a high customer rating and a price range of £20-25.
"name[The Mill], eatType[pub], food[Fast food], priceRange[£20-25], customer rating[high], area[city centre], familyFriendly[yes], near[Café Rouge]"	The Mill is a fast food pub in the city centre near Café Rouge. It is kid friendly and has a high customer rating and a price range of £20-25.
"name[The Mill], eatType[pub], food[Fast food], priceRange[£20-25], customer rating[high], area[riverside], familyFriendly[no], near[Café Rouge]"	The Mill is a fast food pub near Café Rouge in the riverside area. It has a high customer rating and a price range of £20-25 and is not kid friendly.
"name[The Mill], eatType[pub], food[Fast food], priceRange[£20-25], customer rating[high], area[riverside], familyFriendly[yes], near[Café Rouge]"	The Mill is a fast food pub in the riverside area near Café Rouge. It is kid friendly and has a high customer rating and a price range of £20-25.
"name[The Mill], eatType[pub], food[Fast food], priceRange[£20-25], customer rating[high], area[riverside], familyFriendly[yes], near[Café Sicilia]"	The Mill is a fast food pub in the riverside area near Café Sicilia. It is kid friendly and has a high customer rating and a price range of £20-25.
"name[The Mill], eatType[pub], food[Fast food], priceRange[cheap], area[riverside], familyFriendly[yes], near[Raja Indian Cuisine]"	"The Mill is a cheap, family friendly pub that serves fast food. It is located in the riverside area near Raja Indian Cuisine."
"name[The Mill], eatType[pub], food[Fast food], priceRange[cheap], customer rating[5 out of 5], area[city centre], familyFriendly[no], near[Café Sicilia]"	The Mill is a cheap fast food pub in the city centre near Café Sicilia. It is not family-friendly and has a customer rating of 5 out of 5.
"name[The Mill], eatType[pub], food[Fast food], priceRange[cheap], customer rating[5 out of 5], area[city centre], familyFriendly[yes], near[Café Sicilia]"	"The Mill is a cheap, family-friendly pub located near Café Sicilia in the city centre. It serves fast food and has a customer rating of 5 out of 5."
"name[The Mill], eatType[pub], food[Fast food], priceRange[cheap], customer rating[5 out of 5], area[riverside], familyFriendly[no], near[Café Sicilia]"	The Mill is a cheap fast food pub near Café Sicilia in the riverside area. It has a customer rating of 5 out of 5 and is not family-friendly.
"name[The Mill], eatType[pub], food[Fast food], priceRange[cheap], customer rating[5 out of 5], area[riverside], familyFriendly[yes], near[Café Sicilia]"	"The Mill is a cheap, family-friendly pub near Café Sicilia. It has a customer rating of 5 out of 5."
"name[The Mill], eatType[pub], food[Fast food], priceRange[cheap], customer rating[average], area[city centre], familyFriendly[no], near[Café Sicilia]"	The Mill is a cheap fast food pub in the city centre near Café Sicilia. It is not family-friendly and has an average customer rating.
"name[The Mill], eatType[pub], food[Fast food], priceRange[cheap], customer rating[average], area[city centre], familyFriendly[yes], near[Café Sicilia]"	"The Mill is a cheap, family-friendly, fast food pub in the city centre near Café Sicilia. It has an average customer rating."
"name[The Mill], eatType[pub], food[Fast food], priceRange[cheap], customer rating[average], area[riverside], familyFriendly[no], near[Café Sicilia]"	The Mill is a cheap fast food pub in the riverside area near Café Sicilia. It is not family-friendly and has an average customer rating.
"name[The Mill], eatType[pub], food[Fast food], priceRange[cheap], customer rating[average], area[riverside], familyFriendly[yes], near[Café Sicilia]"	"The Mill is a cheap, family friendly pub near Café Sicilia. It is located in the riverside area. It has an average customer rating and serves fast food."
"name[The Mill], eatType[pub], food[Fast food], priceRange[high], customer rating[1 out of 5], area[city centre], familyFriendly[no], near[Café Sicilia]"	The Mill is a fast food pub in the city centre near Café Sicilia. It is not child friendly and has a customer rating of 1 out of 5 and a high price range.
"name[The Mill], eatType[pub], food[Fast food], priceRange[high], customer rating[1 out of 5], area[city centre], familyFriendly[yes], near[Café Sicilia]"	The Mill is a fast food pub in the city centre near Café Sicilia. It is child friendly and has a customer rating of 1 out of 5 and a high price range.
"name[The Mill], eatType[pub], food[Fast food], priceRange[high], customer rating[1 out of 5], area[riverside], familyFriendly[no], near[Café Sicilia]"	The Mill is a fast food pub near Café Sicilia in the riverside area. It is not child friendly and has a customer rating of 1 out of 5.
"name[The Mill], eatType[pub], food[Fast food], priceRange[high], customer rating[1 out of 5], area[riverside], familyFriendly[yes], near[Café Sicilia]"	The Mill is a fast food pub near Café Sicilia in the riverside area. It is child friendly and has a customer rating of 1 out of 5 and a high price range.
"name[The Mill], eatType[pub], food[Fast food], priceRange[high], customer rating[average], area[city centre], familyFriendly[no], near[Café Sicilia]"	The Mill is a fast food pub in the city centre near Café Sicilia. It is not child friendly and has an average customer rating and a high price range.
"name[The Mill], eatType[pub], food[Fast food], priceRange[high], customer rating[average], area[city centre], familyFriendly[yes], near[Café Sicilia]"	The Mill is a fast food pub in the city centre near Café Sicilia. It is child friendly and has an average customer rating and a high price range.
"name[The Mill], eatType[pub], food[Fast food], priceRange[high], customer rating[average], area[riverside], familyFriendly[no], near[Café Sicilia]"	The Mill is a fast food pub near Café Sicilia in the riverside area. It is not child friendly and has an average customer rating and a high price range.
"name[The Mill], eatType[pub], food[Fast food], priceRange[high], customer rating[average], area[riverside], familyFriendly[yes], near[Café Sicilia]"	The Mill is a fast food pub near Café Sicilia in the riverside area. It is children friendly and has a high price range and an average customer rating.
"name[The Mill], eatType[pub], food[Fast food], priceRange[less than £20], customer rating[low], area[city centre], familyFriendly[no], near[Café Sicilia]"	The Mill is a fast food pub in the city centre near Café Sicilia. It is not family-friendly and has a low customer rating. It has a price range of less than £20.
"name[The Mill], eatType[pub], food[Fast food], priceRange[less than £20], customer rating[low], area[city centre], familyFriendly[yes], near[Café Sicilia]"	The Mill is a family-friendly fast food pub in the city centre near Café Sicilia. It has a low customer rating and a price range of less than £20.
"name[The Mill], eatType[pub], food[Fast food], priceRange[less than £20], customer rating[low], area[riverside], familyFriendly[no], near[Café Sicilia]"	The Mill is a low rated pub in the riverside area near Café Sicilia. It is not family-friendly and serves fast food. It has a price range of less than £20.
"name[The Mill], eatType[pub], food[Fast food], priceRange[less than £20], customer rating[low], area[riverside], familyFriendly[yes], near[Café Sicilia]"	The Mill is a family friendly pub that serves fast food. It is located near Café Sicilia in the riverside area. It has a low customer rating and a price range of less than £20.
"name[The Mill], eatType[pub], food[Fast food], priceRange[moderate], customer rating[1 out of 5], area[city centre], familyFriendly[no], near[Café Sicilia]"	The Mill is a pub that serves fast food. It is located near Café Sicilia in the city centre. It has a moderate price range and a customer rating of 1 out of 5.
"name[The Mill], eatType[pub], food[Fast food], priceRange[moderate], customer rating[1 out of 5], area[city centre], familyFriendly[yes], near[Café Sicilia]"	"The Mill is a moderately priced, fast food pub in the city centre near Café Sicilia. It is kid friendly and has a customer rating of 1 out of 5."
"name[The Mill], eatType[pub], food[Fast food], priceRange[moderate], customer rating[1 out of 5], area[riverside], familyFriendly[no], near[Café Sicilia]"	The Mill is a fast food pub in the riverside area near Café Sicilia. It is not kid friendly and has a customer rating of 1 out of 5 and is in the moderate price range.
"name[The Mill], eatType[pub], food[Fast food], priceRange[moderate], customer rating[1 out of 5], area[riverside], familyFriendly[yes], near[Café Sicilia]"	The Mill is a moderately priced pub that serves fast food. It is located in the riverside area near Café Sicilia. It is kid friendly and has a customer rating of 1 out of 5.
"name[The Mill], eatType[pub], food[Fast food], priceRange[moderate], customer rating[3 out of 5], area[city centre], familyFriendly[no], near[Café Sicilia]"	The Mill is a moderately priced fast food pub in the city centre near Café Sicilia. It is not kid friendly and has a customer rating of 3 out of 5.
"name[The Mill], eatType[pub], food[Fast food], priceRange[moderate], customer rating[3 out of 5], area[city centre], familyFriendly[yes], near[Café Sicilia]"	"The Mill is a moderately priced, fast food pub in the city centre near Café Sicilia. It is kid friendly and has a customer rating of 3 out of 5."
"name[The Mill], eatType[pub], food[Fast food], priceRange[moderate], customer rating[3 out of 5], area[riverside], familyFriendly[no], near[Café Sicilia]"	The Mill is a moderately priced pub that serves fast food. It is located near Café Sicilia in the riverside area. It is not kid friendly and has a customer rating of 3 out of 5.
"name[The Mill], eatType[pub], food[Fast food], priceRange[moderate], customer rating[3 out of 5], area[riverside], familyFriendly[yes], near[Café Sicilia]"	The Mill is a moderately priced pub that serves fast food. It is located in the riverside area near Café Sicilia. It is kid friendly and has a customer rating of 3 out of 5.
"name[The Mill], eatType[restaurant], food[English], priceRange[high], area[riverside], familyFriendly[yes], near[Raja Indian Cuisine]"	"The Mill is a high priced, child friendly restaurant located near Raja Indian Cuisine in the riverside area."
"name[The Mill], eatType[restaurant], food[English], priceRange[high], customer rating[average], area[riverside], familyFriendly[yes], near[Café Rouge]"	"The Mill is an expensive, family friendly restaurant located near the Café Rouge."
"name[The Mill], eatType[restaurant], food[English], priceRange[less than £20], area[city centre], familyFriendly[no], near[Raja Indian Cuisine]"	The Mill is an english restaurant located in the city centre near Raja Indian Cuisine. It is not family-friendly and has a price range of less than £20.
"name[The Mill], eatType[restaurant], food[English], priceRange[less than £20], area[city centre], familyFriendly[yes], near[Raja Indian Cuisine]"	The Mill is a family-friendly restaurant located near Raja Indian Cuisine in the city centre. It serves english food for less than £20.
"name[The Mill], eatType[restaurant], food[English], priceRange[less than £20], area[riverside], familyFriendly[no], near[Raja Indian Cuisine]"	The Mill is an english restaurant located near Raja Indian Cuisine in the riverside area. It is not family-friendly and has a price range of less than £20.
"name[The Mill], eatType[restaurant], food[English], priceRange[less than £20], area[riverside], familyFriendly[yes], near[Raja Indian Cuisine]"	The Mill is a family-friendly restaurant located near Raja Indian Cuisine.
"name[The Mill], eatType[restaurant], food[English], priceRange[less than £20], customer rating[low], area[city centre], familyFriendly[no], near[Café Rouge]"	The Mill is an english restaurant located in the city centre near Café Rouge. It is not family-friendly and has a low customer rating.
"name[The Mill], eatType[restaurant], food[English], priceRange[less than £20], customer rating[low], area[city centre], familyFriendly[yes], near[Café Rouge]"	The Mill is a family-friendly english restaurant located near Café Rouge in the city centre. It has a low customer rating and a price range of less than £20.
"name[The Mill], eatType[restaurant], food[English], priceRange[less than £20], customer rating[low], area[riverside], familyFriendly[no], near[Café Rouge]"	The Mill is a low rated restaurant in the riverside area near Café Rouge. It is not family-friendly and serves english food. It has a price range of less than £20.
"name[The Mill], eatType[restaurant], food[English], priceRange[less than £20], customer rating[low], area[riverside], familyFriendly[yes], near[Café Rouge]"	The Mill is a family friendly restaurant located near the Café Rouge.
"name[The Mill], eatType[restaurant], food[English], priceRange[moderate], area[city centre], familyFriendly[no], near[Raja Indian Cuisine]"	The Mill is an english restaurant located in the city centre near Raja Indian Cuisine. It is not kid friendly and has a moderate price range.
"name[The Mill], eatType[restaurant], food[English], priceRange[moderate], area[city centre], familyFriendly[yes], near[Raja Indian Cuisine]"	The Mill is a moderately priced english restaurant located in the city centre near Raja Indian Cuisine. It is kid friendly.
"name[The Mill], eatType[restaurant], food[English], priceRange[moderate], area[riverside], familyFriendly[no], near[Raja Indian Cuisine]"	The Mill is a moderately priced english restaurant near Raja Indian Cuisine in the riverside area. It is not kid friendly.
"name[The Mill], eatType[restaurant], food[English], priceRange[moderate], area[riverside], familyFriendly[yes], near[Raja Indian Cuisine]"	The Mill is a family friendly restaurant located near Raja Indian Cuisine in the riverside area. It serves english food and has a moderate price range.
"name[The Mill], eatType[restaurant], food[English], priceRange[moderate], customer rating[1 out of 5], area[city centre], familyFriendly[no], near[Café Rouge]"	The Mill is a moderately priced english restaurant located in the city centre near Café Rouge. It is not kid friendly and has a customer rating of 1 out of 5.
"name[The Mill], eatType[restaurant], food[English], priceRange[moderate], customer rating[1 out of 5], area[city centre], familyFriendly[yes], near[Café Rouge]"	The Mill is a moderately priced english restaurant located near Café Rouge in the city centre. It has a customer rating of 1 out of 5 and is kid friendly.
"name[The Mill], eatType[restaurant], food[English], priceRange[moderate], customer rating[1 out of 5], area[riverside], familyFriendly[no], near[Café Rouge]"	The Mill is a moderately priced english restaurant located near Café Rouge in the riverside area. It has a customer rating of 1 out of 5 and is not kid friendly.
"name[The Mill], eatType[restaurant], food[English], priceRange[moderate], customer rating[1 out of 5], area[riverside], familyFriendly[yes], near[Café Rouge]"	The Mill is a family friendly restaurant located near Café Rouge. It is moderately priced and has a customer rating of 1 out of 5.
"name[The Mill], eatType[restaurant], food[English], priceRange[moderate], customer rating[3 out of 5], area[city centre], familyFriendly[no], near[Café Rouge]"	The Mill is a moderately priced english restaurant located in the city centre near Café Rouge. It is not kid friendly and has a customer rating of 3 out of 5.
"name[The Mill], eatType[restaurant], food[English], priceRange[moderate], customer rating[3 out of 5], area[city centre], familyFriendly[yes], near[Café Rouge]"	The Mill is an english restaurant located near Café Rouge in the city centre. It is kid friendly and has a moderate price range and a customer rating of 3 out of 5.
"name[The Mill], eatType[restaurant], food[English], priceRange[moderate], customer rating[3 out of 5], area[riverside], familyFriendly[no], near[Café Rouge]"	The Mill is a moderately priced english restaurant located near Café Rouge in the riverside area. It has a customer rating of 3 out of 5 and is not kid friendly.
"name[The Mill], eatType[restaurant], food[English], priceRange[moderate], customer rating[3 out of 5], area[riverside], familyFriendly[yes], near[Café Rouge]"	"The Mill is a moderately priced, kid friendly, english restaurant, located near Café Rouge in the riverside area."
"name[The Mill], eatType[restaurant], food[English], priceRange[more than £30], area[riverside], familyFriendly[yes], near[Raja Indian Cuisine]"	The Mill is a child friendly english restaurant located near Raja Indian Cuisine in the riverside area. The price range is more than £30.
"name[The Mill], eatType[restaurant], food[English], priceRange[more than £30], customer rating[high], area[city centre], familyFriendly[no], near[Café Rouge]"	The Mill is an english restaurant located in the city centre near the Café Rouge. It is not child friendly and has a high customer rating and a price range of more than £30.
"name[The Mill], eatType[restaurant], food[English], priceRange[more than £30], customer rating[high], area[city centre], familyFriendly[yes], near[Café Rouge]"	The Mill is an english restaurant located near Café Rouge in the city centre. It has a high customer rating and is children friendly. The price range is more than £30.
"name[The Mill], eatType[restaurant], food[English], priceRange[more than £30], customer rating[high], area[riverside], familyFriendly[no], near[Café Rouge]"	The Mill is a highly rated restaurant located near Café Rouge in the riverside area. It serves english food and is not child friendly. The price range is more than £30.
"name[The Mill], eatType[restaurant], food[English], priceRange[more than £30], customer rating[high], area[riverside], familyFriendly[yes], near[Café Rouge]"	"The Mill is a highly rated, child friendly, english restaurant, located near Café Rouge in the riverside area. The price range is more than £30."
"name[The Mill], eatType[restaurant], food[Fast food], priceRange[£20-25], area[riverside], familyFriendly[yes], near[Raja Indian Cuisine]"	The Mill is a kid friendly fast food restaurant near Raja Indian Cuisine in the riverside area with a price range of £20-25.
"name[The Mill], eatType[restaurant], food[Fast food], priceRange[cheap], area[riverside], familyFriendly[yes], near[Raja Indian Cuisine]"	"The Mill is a cheap, family friendly fast food restaurant located near Raja Indian Cuisine in the riverside area."
"name[The Phoenix], eatType[pub], food[Fast food], priceRange[cheap], area[riverside], familyFriendly[yes], near[Raja Indian Cuisine]"	"The Phoenix is a cheap, family friendly pub that serves fast food. It is located in the riverside area near Raja Indian Cuisine."
"name[The Phoenix], eatType[pub], food[Fast food], priceRange[high], area[city centre], familyFriendly[no], near[Raja Indian Cuisine]"	The Phoenix is a fast food pub located in the city centre near Raja Indian Cuisine. It is not child friendly and has a high price range.
"name[The Phoenix], eatType[pub], food[Fast food], priceRange[high], area[city centre], familyFriendly[yes], near[Raja Indian Cuisine]"	The Phoenix is a fast food pub in the city centre near Raja Indian Cuisine. It is children friendly and has a high price range.
"name[The Phoenix], eatType[pub], food[Fast food], priceRange[high], area[riverside], familyFriendly[no], near[Raja Indian Cuisine]"	The Phoenix is a fast food pub located near Raja Indian Cuisine in the riverside area. It is not child friendly and has a high price range.
"name[The Phoenix], eatType[pub], food[Fast food], priceRange[high], area[riverside], familyFriendly[yes], near[Raja Indian Cuisine]"	The Phoenix is a high priced pub that serves fast food. It is located near Raja Indian Cuisine in the riverside area. It is children friendly.
"name[The Phoenix], eatType[pub], food[Fast food], priceRange[less than £20], area[city centre], familyFriendly[no], near[Raja Indian Cuisine]"	The Phoenix is a fast food pub in the city centre near Raja Indian Cuisine. It is not family-friendly and has a price range of less than £20.
"name[The Phoenix], eatType[pub], food[Fast food], priceRange[less than £20], area[city centre], familyFriendly[yes], near[Raja Indian Cuisine]"	The Phoenix is a family-friendly fast food pub in the city centre near Raja Indian Cuisine with a price range less than £20.
"name[The Phoenix], eatType[pub], food[Fast food], priceRange[less than £20], area[riverside], familyFriendly[no], near[Raja Indian Cuisine]"	The Phoenix is a fast food pub near Raja Indian Cuisine in the riverside area. It is not family-friendly and has a price range of less than £20.
"name[The Phoenix], eatType[pub], food[Fast food], priceRange[less than £20], area[riverside], familyFriendly[yes], near[Raja Indian Cuisine]"	The Phoenix is a family-friendly pub that serves fast food. It is located near Raja Indian Cuisine in the riverside area. The price range is less than £20.
"name[The Phoenix], eatType[pub], food[Fast food], priceRange[moderate], area[city centre], familyFriendly[no], near[Raja Indian Cuisine]"	The Phoenix is a pub that serves fast food. It is located in the city centre near Raja Indian Cuisine. It is not kid friendly and has a moderate price range.
"name[The Phoenix], eatType[pub], food[Fast food], priceRange[moderate], area[city centre], familyFriendly[yes], near[Raja Indian Cuisine]"	"The Phoenix is a moderately priced, kid-friendly pub serving fast food. It is located in the city centre near Raja Indian Cuisine."
"name[The Phoenix], eatType[pub], food[Fast food], priceRange[moderate], area[riverside], familyFriendly[no], near[Raja Indian Cuisine]"	The Phoenix is a pub that serves fast food. It is located near Raja Indian Cuisine in the riverside area. It is not kid friendly and has a moderate price range.
"name[The Phoenix], eatType[pub], food[Fast food], priceRange[moderate], area[riverside], familyFriendly[yes], near[Raja Indian Cuisine]"	The Phoenix is a moderately priced pub that serves fast food. It is located in the riverside area near Raja Indian Cuisine.
"name[The Phoenix], eatType[pub], food[Fast food], priceRange[moderate], customer rating[3 out of 5], area[riverside], familyFriendly[yes], near[Café Sicilia]"	The Phoenix is a moderately priced pub that serves fast food. It is located in the riverside area near Café Sicilia. It is kid friendly and has a customer rating of 3 out of 5.
"name[The Phoenix], eatType[pub], food[Fast food], priceRange[more than £30], area[riverside], familyFriendly[yes], near[Raja Indian Cuisine]"	The Phoenix is a fast food pub in the riverside area near Raja Indian Cuisine. It is child friendly and has a price range of more than £30.
"name[The Phoenix], eatType[pub], food[Fast food], priceRange[more than £30], customer rating[high], area[city centre], familyFriendly[no], near[Café Sicilia]"	The Phoenix is a fast food pub located in the city centre near Café Sicilia. It is not child friendly and has a high customer rating. The price range is more than £30.
"name[The Phoenix], eatType[pub], food[Fast food], priceRange[more than £30], customer rating[high], area[city centre], familyFriendly[yes], near[Café Sicilia]"	The Phoenix is a fast food pub in the city centre near Café Sicilia. It has a high customer rating and is children friendly. The price range is more than £30.
"name[The Phoenix], eatType[pub], food[Fast food], priceRange[more than £30], customer rating[high], area[riverside], familyFriendly[no], near[Café Sicilia]"	The Phoenix is a fast food pub near Café Sicilia in the riverside area. It is not child friendly and has a high customer rating and a price range of more than £30.
"name[The Phoenix], eatType[pub], food[Fast food], priceRange[more than £30], customer rating[high], area[riverside], familyFriendly[yes], near[Café Sicilia]"	The Phoenix is a pub that serves fast food. It is located near Café Sicilia in the riverside area. It is child friendly and has a high customer rating and a price range of more than £30.
"name[The Phoenix], eatType[pub], food[French], priceRange[£20-25], area[riverside], familyFriendly[yes], near[Raja Indian Cuisine]"	The Phoenix is a kid friendly pub that serves french food. It is located near Raja Indian Cuisine in the riverside area and has a price range of £20-25.
"name[The Phoenix], eatType[pub], food[French], priceRange[£20-25], customer rating[3 out of 5], area[city centre], familyFriendly[no], near[Café Sicilia]"	The Phoenix is a french pub in the city centre near Café Sicilia. It has a customer rating of 3 out of 5. It is not kid friendly and has a price range of £20-25.
"name[The Phoenix], eatType[pub], food[French], priceRange[£20-25], customer rating[3 out of 5], area[city centre], familyFriendly[yes], near[Café Sicilia]"	The Phoenix is a pub that serves french food. It is located near Café Sicilia in the city centre. It is kid friendly and has a customer rating of 3 out of 5.
"name[The Phoenix], eatType[pub], food[French], priceRange[£20-25], customer rating[3 out of 5], area[riverside], familyFriendly[no], near[Café Sicilia]"	The Phoenix is a french pub near Café Sicilia in the riverside area. It is not kid friendly and has a customer rating of 3 out of 5 and a price range of £20-25.
"name[The Phoenix], eatType[pub], food[French], priceRange[£20-25], customer rating[3 out of 5], area[riverside], familyFriendly[yes], near[Café Sicilia]"	The Phoenix is a pub that serves french food. It is located in the riverside area near Café Sicilia. It is kid friendly and has a customer rating of 3 out of 5. The price range is £20-25.
"name[The Phoenix], eatType[pub], food[French], priceRange[£20-25], customer rating[3 out of 5], area[riverside], familyFriendly[yes], near[Crowne Plaza Hotel]"	The Phoenix is a pub that serves french food. It is located in the riverside area near Crowne Plaza Hotel. It is kid friendly and has a customer rating of 3 out of 5. The price range is £20-25.
"name[The Phoenix], eatType[pub], food[French], priceRange[£20-25], customer rating[high], area[city centre], familyFriendly[no], near[Crowne Plaza Hotel]"	The Phoenix is a french pub in the city centre near Crowne Plaza Hotel. It has a high customer rating and a price range of £20-25 and is not child friendly.
"name[The Phoenix], eatType[pub], food[French], priceRange[£20-25], customer rating[high], area[city centre], familyFriendly[yes], near[Crowne Plaza Hotel]"	The Phoenix is a pub that serves french food. It is located in the city centre near Crowne Plaza Hotel. It is kid friendly and has a high customer rating and a price range of £20-25.
"name[The Phoenix], eatType[pub], food[French], priceRange[£20-25], customer rating[high], area[riverside], familyFriendly[no], near[Crowne Plaza Hotel]"	The Phoenix is a french pub near Crowne Plaza Hotel in the riverside area. It has a high customer rating and a price range of £20-25 and is not kid friendly.
"name[The Phoenix], eatType[pub], food[French], priceRange[£20-25], customer rating[high], area[riverside], familyFriendly[yes], near[Crowne Plaza Hotel]"	The Phoenix is a pub that serves french food. It is located in the riverside area near Crowne Plaza Hotel. It is kid friendly and has a high customer rating and a price range of £20-25.
"name[The Phoenix], eatType[pub], food[French], priceRange[cheap], area[riverside], familyFriendly[yes], near[Raja Indian Cuisine]"	The Phoenix is a cheap pub that serves french food. It is located near Raja Indian Cuisine in the riverside area. It is family friendly.
"name[The Phoenix], eatType[pub], food[French], priceRange[cheap], customer rating[5 out of 5], area[city centre], familyFriendly[no], near[Crowne Plaza Hotel]"	The Phoenix is a cheap french pub in the city centre near Crowne Plaza Hotel. It is not family-friendly and has a customer rating of 5 out of 5.
"name[The Phoenix], eatType[pub], food[French], priceRange[cheap], customer rating[5 out of 5], area[city centre], familyFriendly[yes], near[Crowne Plaza Hotel]"	The Phoenix is a family-friendly french pub in the city centre near Crowne Plaza Hotel. It has a customer rating of 5 out of 5 and a cheap price range.
"name[The Phoenix], eatType[pub], food[French], priceRange[cheap], customer rating[5 out of 5], area[riverside], familyFriendly[no], near[Crowne Plaza Hotel]"	The Phoenix is a cheap french pub near Crowne Plaza Hotel in the riverside area. It has a customer rating of 5 out of 5 and is not family-friendly.
"name[The Phoenix], eatType[pub], food[French], priceRange[cheap], customer rating[5 out of 5], area[riverside], familyFriendly[yes], near[Crowne Plaza Hotel]"	The Phoenix is a family friendly pub that serves french food. It is located in the riverside area near Crowne Plaza Hotel. It has a customer rating of 5 out of 5 and is cheap.
"name[The Phoenix], eatType[pub], food[French], priceRange[high], area[riverside], familyFriendly[yes], near[Raja Indian Cuisine]"	The Phoenix is a pub that serves french food. It is located near Raja Indian Cuisine in the riverside area. It is child friendly and has a high price range.
"name[The Phoenix], eatType[pub], food[French], priceRange[high], customer rating[3 out of 5], area[city centre], familyFriendly[no], near[Crowne Plaza Hotel]"	The Phoenix is a french pub in the city centre near Crowne Plaza Hotel. It has a high price range and a customer rating of 3 out of 5. It is not child friendly.
"name[The Phoenix], eatType[pub], food[French], priceRange[high], customer rating[3 out of 5], area[city centre], familyFriendly[yes], near[Crowne Plaza Hotel]"	The Phoenix is a french pub in the city centre near Crowne Plaza Hotel. It is child friendly and has a customer rating of 3 out of 5 and a high price range.
"name[The Phoenix], eatType[pub], food[French], priceRange[high], customer rating[3 out of 5], area[riverside], familyFriendly[no], near[Crowne Plaza Hotel]"	The Phoenix is a french pub near Crowne Plaza Hotel in the riverside area. It is not child friendly and has a customer rating of 3 out of 5 and a high price range.
"name[The Phoenix], eatType[pub], food[French], priceRange[high], customer rating[3 out of 5], area[riverside], familyFriendly[yes], near[Crowne Plaza Hotel]"	The Phoenix is a pub that serves french food. It is located near Crowne Plaza Hotel in the riverside area. It is children friendly and has a customer rating of 3 out of 5.
"name[The Phoenix], eatType[pub], food[French], priceRange[less than £20], customer rating[average], area[city centre], familyFriendly[no], near[Crowne Plaza Hotel]"	The Phoenix is a french pub in the city centre near Crowne Plaza Hotel. It is not family-friendly and has an average customer rating. It has a price range of less than £20.
"name[The Phoenix], eatType[pub], food[French], priceRange[less than £20], customer rating[average], area[city centre], familyFriendly[yes], near[Crowne Plaza Hotel]"	The Phoenix is a family-friendly pub that serves french food. It is located in the city centre near Crowne Plaza Hotel. It has an average customer rating and a price range of less than £20.
"name[The Phoenix], eatType[pub], food[French], priceRange[less than £20], customer rating[average], area[riverside], familyFriendly[no], near[Crowne Plaza Hotel]"	The Phoenix is a pub that serves french food. It is located near Crowne Plaza Hotel in the riverside area. It is not family-friendly and has an average customer rating.
"name[The Phoenix], eatType[pub], food[French], priceRange[less than £20], customer rating[average], area[riverside], familyFriendly[yes], near[Crowne Plaza Hotel]"	The Phoenix is a family-friendly pub that serves french food. It is located near Crowne Plaza Hotel in the riverside area. It has an average customer rating and a price range of less than £20.
"name[The Phoenix], eatType[pub], food[French], priceRange[less than £20], customer rating[low], area[city centre], familyFriendly[no], near[Crowne Plaza Hotel]"	The Phoenix is a french pub in the city centre near Crowne Plaza Hotel. It is not family-friendly and has a low customer rating and a price range of less than £20.
"name[The Phoenix], eatType[pub], food[French], priceRange[less than £20], customer rating[low], area[city centre], familyFriendly[yes], near[Crowne Plaza Hotel]"	The Phoenix is a family-friendly pub that serves french food. It is located in the city centre near Crowne Plaza Hotel. It has a low customer rating and a price range of less than £20.
"name[The Phoenix], eatType[pub], food[French], priceRange[less than £20], customer rating[low], area[riverside], familyFriendly[no], near[Crowne Plaza Hotel]"	The Phoenix is a low-priced pub in the city centre near Crowne Plaza Hotel. It is not family-friendly and has a low customer rating.
"name[The Phoenix], eatType[pub], food[French], priceRange[less than £20], customer rating[low], area[riverside], familyFriendly[yes], near[Crowne Plaza Hotel]"	The Phoenix is a family friendly pub that serves french food. It is located near Crowne Plaza Hotel in the riverside area. It has a low customer rating and a price range of less than £20.
"name[The Phoenix], eatType[pub], food[French], priceRange[moderate], customer rating[1 out of 5], area[city centre], familyFriendly[no], near[Crowne Plaza Hotel]"	The Phoenix is a french pub in the city centre near Crowne Plaza Hotel. It is not kid friendly and has a customer rating of 1 out of 5 and is in the moderate price range.
"name[The Phoenix], eatType[pub], food[French], priceRange[moderate], customer rating[1 out of 5], area[city centre], familyFriendly[yes], near[Crowne Plaza Hotel]"	The Phoenix is a pub that serves french food. It is located near Crowne Plaza Hotel in the city centre. It is kid friendly and has a customer rating of 1 out of 5.
"name[The Phoenix], eatType[pub], food[French], priceRange[moderate], customer rating[1 out of 5], area[riverside], familyFriendly[no], near[Crowne Plaza Hotel]"	The Phoenix is a pub that serves french food. It is located near Crowne Plaza Hotel in the riverside area. It is not kid friendly and has a customer rating of 1 out of 5.
"name[The Phoenix], eatType[pub], food[French], priceRange[moderate], customer rating[1 out of 5], area[riverside], familyFriendly[yes], near[Crowne Plaza Hotel]"	The Phoenix is a pub that serves french food. It is located in the riverside area near Crowne Plaza Hotel. It is kid friendly and has a customer rating of 1 out of 5.
"name[The Phoenix], eatType[pub], food[French], priceRange[more than £30], customer rating[5 out of 5], area[city centre], familyFriendly[no], near[Crowne Plaza Hotel]"	The Phoenix is a french pub located in the city centre near Crowne Plaza Hotel. It is not child friendly and has a customer rating of 5 out of 5.
"name[The Phoenix], eatType[pub], food[French], priceRange[more than £30], customer rating[5 out of 5], area[city centre], familyFriendly[yes], near[Crowne Plaza Hotel]"	The Phoenix is a pub that serves french food. It is located in the city centre near Crowne Plaza Hotel. It has a customer rating of 5 out of 5 and is in the city centre. It is children friendly and has a price range of more than £30.
"name[The Phoenix], eatType[pub], food[French], priceRange[more than £30], customer rating[5 out of 5], area[riverside], familyFriendly[no], near[Crowne Plaza Hotel]"	The Phoenix is a pub that serves french food. It is located near Crowne Plaza Hotel in the riverside area. It has a customer rating of 5 out of 5. It is not child friendly and has a price range of more than £30.
"name[The Phoenix], eatType[pub], food[French], priceRange[more than £30], customer rating[5 out of 5], area[riverside], familyFriendly[yes], near[Crowne Plaza Hotel]"	The Phoenix is a pub that serves french food. It is located near Crowne Plaza Hotel in the riverside area. It has a customer rating of 5 out of 5 and is children friendly and has a price range of more than £30.
"name[The Phoenix], eatType[pub], food[French], priceRange[more than £30], customer rating[low], area[city centre], familyFriendly[no], near[Crowne Plaza Hotel]"	The Phoenix is a french pub in the city centre near Crowne Plaza Hotel. It is not child friendly and has a low customer rating and a price range of more than £30.
"name[The Phoenix], eatType[pub], food[French], priceRange[more than £30], customer rating[low], area[city centre], familyFriendly[yes], near[Crowne Plaza Hotel]"	The Phoenix is a pub that serves french food. It is located near Crowne Plaza Hotel in the city centre. It has a low customer rating and a price range of more than £30. It is a pub that is children friendly.
"name[The Phoenix], eatType[pub], food[French], priceRange[more than £30], customer rating[low], area[riverside], familyFriendly[no], near[Crowne Plaza Hotel]"	The Phoenix is a french pub near Crowne Plaza Hotel in the riverside area. It is not child friendly and has a low customer rating and a price range of more than £30.
"name[The Phoenix], eatType[pub], food[French], priceRange[more than £30], customer rating[low], area[riverside], familyFriendly[yes], near[Crowne Plaza Hotel]"	The Phoenix is a pub that serves french food. It is located near Crowne Plaza Hotel in the riverside area. It is children friendly and has a low customer rating and a price range of more than £30.
"name[The Phoenix], eatType[restaurant], food[Fast food], priceRange[cheap], area[riverside], familyFriendly[yes], near[Raja Indian Cuisine]"	"The Phoenix is a cheap, family friendly fast food restaurant located near Raja Indian Cuisine in the riverside area."
"name[The Phoenix], eatType[restaurant], food[Fast food], priceRange[high], area[city centre], familyFriendly[no], near[Raja Indian Cuisine]"	The Phoenix is a fast food restaurant located in the city centre near Raja Indian Cuisine. It is not child friendly and has a high price range.
"name[The Phoenix], eatType[restaurant], food[Fast food], priceRange[high], area[city centre], familyFriendly[yes], near[Raja Indian Cuisine]"	The Phoenix is a fast food restaurant located in the city centre near Raja Indian Cuisine. It is child friendly and has a high price range.
"name[The Phoenix], eatType[restaurant], food[Fast food], priceRange[high], area[riverside], familyFriendly[no], near[Raja Indian Cuisine]"	The Phoenix is a fast food restaurant located near Raja Indian Cuisine in the riverside area. It is not child friendly and has a high price range.
"name[The Phoenix], eatType[restaurant], food[Fast food], priceRange[high], area[riverside], familyFriendly[yes], near[Raja Indian Cuisine]"	The Phoenix is a fast food restaurant near Raja Indian Cuisine in the riverside area. It is children friendly and has a high price range.
"name[The Phoenix], eatType[restaurant], food[Fast food], priceRange[less than £20], area[city centre], familyFriendly[no], near[Raja Indian Cuisine]"	The Phoenix is a fast food restaurant in the city centre near Raja Indian Cuisine. It is not family-friendly and has a price range of less than £20.
"name[The Phoenix], eatType[restaurant], food[Fast food], priceRange[less than £20], area[city centre], familyFriendly[yes], near[Raja Indian Cuisine]"	The Phoenix is a family-friendly fast food restaurant located in the city centre near Raja Indian Cuisine with a price range less than £20.
"name[The Phoenix], eatType[restaurant], food[Fast food], priceRange[less than £20], area[riverside], familyFriendly[no], near[Raja Indian Cuisine]"	The Phoenix is a fast food restaurant located near Raja Indian Cuisine in the riverside area. It is not family-friendly and has a price range of less than £20.
"name[The Phoenix], eatType[restaurant], food[Fast food], priceRange[less than £20], area[riverside], familyFriendly[yes], near[Raja Indian Cuisine]"	The Phoenix is a family-friendly fast food restaurant located near Raja Indian Cuisine in the riverside area with a price range of less than £20.
"name[The Phoenix], eatType[restaurant], food[Fast food], priceRange[moderate], area[city centre], familyFriendly[no], near[Raja Indian Cuisine]"	The Phoenix is a moderately priced fast food restaurant located in the city centre near Raja Indian Cuisine. It is not kid friendly.
"name[The Phoenix], eatType[restaurant], food[Fast food], priceRange[moderate], area[city centre], familyFriendly[yes], near[Raja Indian Cuisine]"	The Phoenix is a family-friendly fast food restaurant located near Raja Indian Cuisine in the city centre with a moderate price range.
"name[The Phoenix], eatType[restaurant], food[Fast food], priceRange[moderate], area[riverside], familyFriendly[no], near[Raja Indian Cuisine]"	The Phoenix is a fast food restaurant located near Raja Indian Cuisine in the riverside area. It is not kid friendly and has a moderate price range.
"name[The Phoenix], eatType[restaurant], food[Fast food], priceRange[moderate], area[riverside], familyFriendly[yes], near[Raja Indian Cuisine]"	The Phoenix is a fast food restaurant near Raja Indian Cuisine in the riverside area. It is kid friendly and has a moderate price range.
"name[The Phoenix], eatType[restaurant], food[Fast food], priceRange[more than £30], area[riverside], familyFriendly[yes], near[Raja Indian Cuisine]"	The Phoenix is a fast food restaurant near Raja Indian Cuisine in the riverside area. It is children friendly and has a price range of more than £30.
"name[The Phoenix], eatType[restaurant], food[French], priceRange[£20-25], area[riverside], familyFriendly[yes], near[Raja Indian Cuisine]"	The Phoenix is a french restaurant near Raja Indian Cuisine in the riverside area. It is kid friendly and has a price range of £20-25.
"name[The Phoenix], eatType[restaurant], food[French], priceRange[cheap], area[riverside], familyFriendly[yes], near[Raja Indian Cuisine]"	The Phoenix is a cheap french restaurant near Raja Indian Cuisine in the riverside area. It is family friendly.
"name[The Phoenix], eatType[restaurant], food[French], priceRange[high], area[riverside], familyFriendly[yes], near[Raja Indian Cuisine]"	The Phoenix is a french restaurant located near Raja Indian Cuisine in the riverside area. It is child friendly and has a high price range.
"name[The Phoenix], eatType[restaurant], food[Indian], priceRange[£20-25], customer rating[high], area[city centre], familyFriendly[no], near[Crowne Plaza Hotel]"	The Phoenix is an indian restaurant located in the city centre near Crowne Plaza Hotel. It has a high customer rating and a price range of £20-25 and is not kid friendly.
"name[The Phoenix], eatType[restaurant], food[Indian], priceRange[£20-25], customer rating[high], area[city centre], familyFriendly[yes], near[Crowne Plaza Hotel]"	The Phoenix is an indian restaurant located in the city centre near Crowne Plaza Hotel. It has a high customer rating and a price range of £20-25 and is kid friendly.
"name[The Phoenix], eatType[restaurant], food[Indian], priceRange[£20-25], customer rating[high], area[riverside], familyFriendly[no], near[Crowne Plaza Hotel]"	The Phoenix is a highly rated indian restaurant in the riverside area near Crowne Plaza Hotel. It is not kid friendly and has a price range of £20-25.
"name[The Phoenix], eatType[restaurant], food[Indian], priceRange[£20-25], customer rating[high], area[riverside], familyFriendly[yes], near[Crowne Plaza Hotel]"	The Phoenix is an indian restaurant located near Crowne Plaza Hotel in the riverside area. It has a high customer rating and is kid friendly and has a price range of £20-25.
"name[The Phoenix], eatType[restaurant], food[Indian], priceRange[cheap], customer rating[5 out of 5], area[city centre], familyFriendly[no], near[Crowne Plaza Hotel]"	The Phoenix is a cheap indian restaurant in the city centre near Crowne Plaza Hotel. It has a customer rating of 5 out of 5 and is not family-friendly.
"name[The Phoenix], eatType[restaurant], food[Indian], priceRange[cheap], customer rating[5 out of 5], area[city centre], familyFriendly[yes], near[Crowne Plaza Hotel]"	The Phoenix is a cheap indian restaurant in the city centre near Crowne Plaza Hotel. It has a customer rating of 5 out of 5 and is family-friendly.
"name[The Phoenix], eatType[restaurant], food[Indian], priceRange[cheap], customer rating[5 out of 5], area[riverside], familyFriendly[no], near[Crowne Plaza Hotel]"	The Phoenix is a cheap indian restaurant in the riverside area near Crowne Plaza Hotel. It has a customer rating of 5 out of 5 and is not family-friendly.
"name[The Phoenix], eatType[restaurant], food[Indian], priceRange[cheap], customer rating[5 out of 5], area[riverside], familyFriendly[no], near[Express by Holiday Inn]"	The Phoenix is a cheap indian restaurant in the riverside area near Express by Holiday Inn. It has a customer rating of 5 out of 5 and is not family-friendly.
"name[The Phoenix], eatType[restaurant], food[Indian], priceRange[cheap], customer rating[5 out of 5], area[riverside], familyFriendly[yes], near[Express by Holiday Inn]"	The Phoenix is a cheap indian restaurant near Express by Holiday Inn in the riverside area. It has a customer rating of 5 out of 5 and is family friendly.
"name[The Phoenix], eatType[restaurant], food[Indian], priceRange[cheap], customer rating[average], area[city centre], familyFriendly[no], near[Express by Holiday Inn]"	The Phoenix is a cheap indian restaurant in the city centre near Express by Holiday Inn. It has an average customer rating and is not family-friendly.
"name[The Plough], eatType[pub], food[Chinese], priceRange[£20-25], area[riverside], familyFriendly[yes], near[Raja Indian Cuisine]"	The Plough is a pub that serves chinese food in the riverside area near Raja Indian Cuisine. It is kid friendly and has a price range of £20-25.
"name[The Plough], eatType[pub], food[Chinese], priceRange[cheap], area[riverside], familyFriendly[yes], near[Raja Indian Cuisine]"	The Plough is a cheap pub that serves chinese food. It is located near Raja Indian Cuisine in the riverside area. It is family friendly.
"name[The Plough], eatType[pub], food[Chinese], priceRange[high], area[city centre], familyFriendly[no], near[Raja Indian Cuisine]"	The Plough is a pub that serves chinese food. It is located in the city centre near Raja Indian Cuisine. It is not child friendly and has a high price range.
"name[The Plough], eatType[pub], food[Chinese], priceRange[high], area[city centre], familyFriendly[yes], near[Raja Indian Cuisine]"	The Plough is a pub that serves chinese food. It is located in the city centre near Raja Indian Cuisine. It is child friendly and has a high price range.
"name[The Plough], eatType[pub], food[Chinese], priceRange[high], area[riverside], familyFriendly[no], near[Raja Indian Cuisine]"	The Plough is a pub that serves chinese food. It is located near Raja Indian Cuisine in the riverside area. It is not child friendly and has a high price range.
"name[The Plough], eatType[pub], food[Chinese], priceRange[high], area[riverside], familyFriendly[yes], near[Raja Indian Cuisine]"	The Plough is a pub that provides chinese food in the high price range. It is located in the riverside area near Raja Indian Cuisine.
"name[The Plough], eatType[pub], food[Chinese], priceRange[less than £20], area[city centre], familyFriendly[no], near[Raja Indian Cuisine]"	"The Plough is a pub that serves chinese food in the less than £20 price range. It is located in the city centre, near Raja Indian Cuisine. It is not family friendly."
"name[The Plough], eatType[restaurant], food[Chinese], priceRange[£20-25], area[riverside], familyFriendly[yes], near[Raja Indian Cuisine]"	The Plough is a chinese restaurant in the riverside area near Raja Indian Cuisine. It is kid friendly and has a price range of £20-25.
"name[The Plough], eatType[restaurant], food[Chinese], priceRange[cheap], area[riverside], familyFriendly[yes], near[Raja Indian Cuisine]"	The Plough is a family friendly chinese restaurant near Raja Indian Cuisine in the riverside area. It has a cheap price range.
"name[The Plough], eatType[restaurant], food[Chinese], priceRange[high], area[city centre], familyFriendly[no], near[Raja Indian Cuisine]"	The Plough provides chinese food in the high price range. It is located in the city centre near Raja Indian Cuisine.
"name[The Plough], eatType[restaurant], food[Chinese], priceRange[high], area[city centre], familyFriendly[yes], near[Raja Indian Cuisine]"	The Plough provides chinese food in the high price range. It is located in the city centre near Raja Indian Cuisine.
"name[The Plough], eatType[restaurant], food[Chinese], priceRange[high], area[riverside], familyFriendly[no], near[Raja Indian Cuisine]"	The Plough is a chinese restaurant located near Raja Indian Cuisine in the riverside area. It is not child friendly and has a high price range.
"name[The Plough], eatType[restaurant], food[Chinese], priceRange[high], area[riverside], familyFriendly[yes], near[Raja Indian Cuisine]"	The Plough is a chinese restaurant located near Raja Indian Cuisine in the riverside area. It is child friendly and has a high price range.
"name[The Plough], eatType[restaurant], food[Chinese], priceRange[less than £20], area[city centre], familyFriendly[no], near[Raja Indian Cuisine]"	The Plough is a chinese restaurant located in the city centre near Raja Indian Cuisine. It is not family friendly and has a price range of less than £20.
"name[The Punter], eatType[pub], food[Chinese], priceRange[less than £20], area[city centre], familyFriendly[yes], near[Raja Indian Cuisine]"	The Punter is a family friendly pub that serves chinese food. It is located in the city centre near Raja Indian Cuisine. It has a price range of less than £20.
"name[The Punter], eatType[pub], food[Chinese], priceRange[less than £20], area[riverside], familyFriendly[no], near[Raja Indian Cuisine]"	The Punter is a pub that serves chinese food for less than £20. It is located near Raja Indian Cuisine in the riverside area. It is not family friendly.
"name[The Punter], eatType[pub], food[Chinese], priceRange[less than £20], area[riverside], familyFriendly[yes], near[Raja Indian Cuisine]"	The Punter is a pub that serves chinese food for less than £20. It is family friendly and is located near Raja Indian Cuisine in the riverside area.
"name[The Punter], eatType[pub], food[Chinese], priceRange[moderate], area[city centre], familyFriendly[no], near[Raja Indian Cuisine]"	"The Punter is a pub that serves chinese food in the moderate price range. It is located in the city centre, near Raja Indian Cuisine. It is not kid friendly."
"name[The Punter], eatType[pub], food[Chinese], priceRange[moderate], area[city centre], familyFriendly[yes], near[Raja Indian Cuisine]"	The Punter is a pub that serves chinese food in the moderate price range. It is located in the city centre near Raja Indian Cuisine. It is kid friendly.
"name[The Punter], eatType[pub], food[Chinese], priceRange[moderate], area[riverside], familyFriendly[no], near[Raja Indian Cuisine]"	The Punter is a pub that serves chinese food in the moderate price range. It is located in the riverside area near Raja Indian Cuisine. It is not kid friendly.
"name[The Punter], eatType[pub], food[Chinese], priceRange[moderate], area[riverside], familyFriendly[yes], near[Raja Indian Cuisine]"	The Punter is a pub that provides chinese food in the moderate price range. It is located in the riverside area near Raja Indian Cuisine.
"name[The Punter], eatType[pub], food[Chinese], priceRange[more than £30], area[riverside], familyFriendly[yes], near[Raja Indian Cuisine]"	The Punter is a pub that provides chinese food in the more than £30 price range. It is located in the riverside. It is near Raja Indian Cuisine.
"name[The Punter], eatType[pub], food[English], priceRange[£20-25], area[riverside], familyFriendly[yes], near[Raja Indian Cuisine]"	The Punter is a kid friendly pub that serves english food. It is located near Raja Indian Cuisine in the riverside area and has a price range of £20-25.
"name[The Punter], eatType[pub], food[English], priceRange[cheap], area[riverside], familyFriendly[yes], near[Raja Indian Cuisine]"	The Punter is a family friendly pub that serves english food. It is located near Raja Indian Cuisine in the riverside area. It has a cheap price range.
"name[The Punter], eatType[pub], food[English], priceRange[high], area[city centre], familyFriendly[no], near[Raja Indian Cuisine]"	The Punter is a pub that serves english food. It is located in the city centre near Raja Indian Cuisine. It is not child friendly and has a high price range.
"name[The Punter], eatType[pub], food[English], priceRange[high], area[city centre], familyFriendly[yes], near[Raja Indian Cuisine]"	The Punter is a pub that serves english food. It is located in the city centre near Raja Indian Cuisine. It is child friendly and has a high price range.
"name[The Punter], eatType[pub], food[English], priceRange[high], area[riverside], familyFriendly[no], near[Raja Indian Cuisine]"	The Punter is a pub near Raja Indian Cuisine in the riverside area. It is not child friendly and serves english food. It has a high price range.
"name[The Punter], eatType[pub], food[English], priceRange[high], area[riverside], familyFriendly[yes], near[Raja Indian Cuisine]"	The Punter is a high-priced pub in the riverside area near Raja Indian Cuisine. It serves english food and is child friendly.
"name[The Punter], eatType[pub], food[Italian], priceRange[high], customer rating[average], area[city centre], familyFriendly[no], near[Rainbow Vegetarian Café]"	The Punter is an italian pub located near Rainbow Vegetarian Café in the city centre. It is not child friendly and has an average customer rating.
"name[The Punter], eatType[restaurant], food[Chinese], priceRange[less than £20], area[city centre], familyFriendly[yes], near[Raja Indian Cuisine]"	The Punter is a family friendly chinese restaurant in the city centre near Raja Indian Cuisine. The price range is less than 20 pounds.
"name[The Punter], eatType[restaurant], food[Chinese], priceRange[less than £20], area[riverside], familyFriendly[no], near[Raja Indian Cuisine]"	The Punter is a chinese restaurant located near Raja Indian Cuisine in the riverside area. It is not family friendly and has a price range of less than £20.
"name[The Punter], eatType[restaurant], food[Chinese], priceRange[less than £20], area[riverside], familyFriendly[yes], near[Raja Indian Cuisine]"	The Punter is a chinese restaurant in the riverside area near Raja Indian Cuisine. It is family friendly and has a price range of less than £20.
"name[The Punter], eatType[restaurant], food[Chinese], priceRange[moderate], area[city centre], familyFriendly[no], near[Raja Indian Cuisine]"	The Punter is a chinese restaurant located in the city centre near Raja Indian Cuisine. It is not kid friendly and has a moderate price range.
"name[The Punter], eatType[restaurant], food[Chinese], priceRange[moderate], area[city centre], familyFriendly[yes], near[Raja Indian Cuisine]"	The Punter is a chinese restaurant located in the city centre near Raja Indian Cuisine. It is kid friendly and has a moderate price range.
"name[The Punter], eatType[restaurant], food[Chinese], priceRange[moderate], area[riverside], familyFriendly[no], near[Raja Indian Cuisine]"	The Punter is a chinese restaurant located near Raja Indian Cuisine in the riverside area. It is not kid friendly and has a moderate price range.
"name[The Punter], eatType[restaurant], food[Chinese], priceRange[moderate], area[riverside], familyFriendly[yes], near[Raja Indian Cuisine]"	The Punter is a chinese restaurant located near Raja Indian Cuisine in the riverside area. It is kid friendly and has a moderate price range.
"name[The Punter], eatType[restaurant], food[Chinese], priceRange[more than £30], area[riverside], familyFriendly[yes], near[Raja Indian Cuisine]"	The Punter is a chinese restaurant located near Raja Indian Cuisine in the riverside area. It is child friendly and has a price range of more than £30.
"name[The Punter], eatType[restaurant], food[English], priceRange[£20-25], area[riverside], familyFriendly[yes], near[Raja Indian Cuisine]"	The Punter is a kid friendly english restaurant near Raja Indian Cuisine in the riverside area with a price range of £20-25.
"name[The Punter], eatType[restaurant], food[English], priceRange[cheap], area[riverside], familyFriendly[yes], near[Raja Indian Cuisine]"	"The Punter is a cheap, family friendly english restaurant located near Raja Indian Cuisine in the riverside area."
"name[The Punter], eatType[restaurant], food[English], priceRange[high], area[city centre], familyFriendly[no], near[Raja Indian Cuisine]"	The Punter is an english restaurant located in the city centre near Raja Indian Cuisine. It is not child friendly and has a high price range.
"name[The Punter], eatType[restaurant], food[English], priceRange[high], area[city centre], familyFriendly[yes], near[Raja Indian Cuisine]"	The Punter is an english restaurant located in the city centre near Raja Indian Cuisine. It is child friendly and has a high price range.
"name[The Punter], eatType[restaurant], food[English], priceRange[high], area[riverside], familyFriendly[no], near[Raja Indian Cuisine]"	The Punter is an expensive restaurant located near Raja Indian Cuisine in the riverside area. It serves english food and is not child friendly.
"name[The Punter], eatType[restaurant], food[English], priceRange[high], area[riverside], familyFriendly[yes], near[Raja Indian Cuisine]"	"The Punter is a high priced, child friendly restaurant located near Raja Indian Cuisine in the riverside area."
"name[The Punter], eatType[restaurant], food[Indian], priceRange[cheap], customer rating[average], area[city centre], familyFriendly[yes], near[Express by Holiday Inn]"	The Punter is a cheap indian restaurant in the city centre near Express by Holiday Inn. It has an average customer rating and is family-friendly.
"name[The Punter], eatType[restaurant], food[Indian], priceRange[cheap], customer rating[average], area[riverside], familyFriendly[no], near[Express by Holiday Inn]"	The Punter is a cheap indian restaurant in the riverside area near Express by Holiday Inn. It has an average customer rating and is not family friendly.
"name[The Punter], eatType[restaurant], food[Indian], priceRange[cheap], customer rating[average], area[riverside], familyFriendly[yes], near[Express by Holiday Inn]"	The Punter is a cheap indian restaurant near Express by Holiday Inn in the riverside area. It has an average customer rating and is family friendly.
"name[The Punter], eatType[restaurant], food[Indian], priceRange[high], customer rating[1 out of 5], area[city centre], familyFriendly[no], near[Express by Holiday Inn]"	The Punter is an indian restaurant located in the city centre near Express by Holiday Inn. It is not child friendly and has a customer rating of 1 out of 5.
"name[The Punter], eatType[restaurant], food[Indian], priceRange[high], customer rating[1 out of 5], area[city centre], familyFriendly[yes], near[Express by Holiday Inn]"	The Punter is an indian restaurant located in the city centre near Express by Holiday Inn. It is child friendly and has a customer rating of 1 out of 5 and a high price range.
"name[The Punter], eatType[restaurant], food[Indian], priceRange[high], customer rating[1 out of 5], area[riverside], familyFriendly[no], near[Express by Holiday Inn]"	The Punter is a restaurant providing indian food in the high price range. It is located in the riverside. It is near Express by Holiday Inn. Its customer rating is 1 out of 5.
"name[The Punter], eatType[restaurant], food[Indian], priceRange[high], customer rating[1 out of 5], area[riverside], familyFriendly[yes], near[Express by Holiday Inn]"	The Punter is an indian restaurant located near Express by Holiday Inn in the riverside area. It is child friendly and has a customer rating of 1 out of 5 and a high price range.
"name[The Punter], eatType[restaurant], food[Indian], priceRange[high], customer rating[average], area[city centre], familyFriendly[no], near[Express by Holiday Inn]"	The Punter is an indian restaurant located near Express by Holiday Inn in the city centre. It is not child friendly and has an average customer rating.
"name[The Punter], eatType[restaurant], food[Indian], priceRange[high], customer rating[average], area[city centre], familyFriendly[yes], near[Express by Holiday Inn]"	The Punter is an indian restaurant located near Express by Holiday Inn in the city centre. It is child friendly and has an average customer rating.
"name[The Punter], eatType[restaurant], food[Indian], priceRange[high], customer rating[average], area[riverside], familyFriendly[no], near[Express by Holiday Inn]"	The Punter is an indian restaurant located near Express by Holiday Inn in the riverside area. It is not child friendly and has an average customer rating.
"name[The Punter], eatType[restaurant], food[Indian], priceRange[high], customer rating[average], area[riverside], familyFriendly[yes], near[Express by Holiday Inn]"	The Punter is an indian restaurant with a high price range. It is located near Express by Holiday Inn in the riverside area. It is children friendly and has an average customer rating.
"name[The Punter], eatType[restaurant], food[Indian], priceRange[less than £20], customer rating[low], area[city centre], familyFriendly[no], near[Express by Holiday Inn]"	"The Punter is an indian restaurant with a price range less than £20. It is located in the city centre, near Express by Holiday Inn. It is not family-friendly and has a low customer rating."
"name[The Punter], eatType[restaurant], food[Indian], priceRange[less than £20], customer rating[low], area[city centre], familyFriendly[yes], near[Express by Holiday Inn]"	"The Punter is an indian restaurant with a price range less than £20. It is located in the city centre, near Express by Holiday Inn. It is family-friendly and has a low customer rating."
"name[The Punter], eatType[restaurant], food[Indian], priceRange[less than £20], customer rating[low], area[riverside], familyFriendly[no], near[Express by Holiday Inn]"	The Punter is an indian restaurant with a price range less than £20. It is located in the riverside. It is near Express by Holiday Inn. It is not family friendly and has a low customer rating.
"name[The Punter], eatType[restaurant], food[Indian], priceRange[less than £20], customer rating[low], area[riverside], familyFriendly[yes], near[Express by Holiday Inn]"	The Punter is a family friendly indian restaurant with a price range less than £20. It is located in the riverside area near Express by Holiday Inn. It has a low customer rating.
"name[The Punter], eatType[restaurant], food[Indian], priceRange[moderate], customer rating[1 out of 5], area[city centre], familyFriendly[no], near[Express by Holiday Inn]"	The Punter is an indian restaurant located in the city centre near Express by Holiday Inn. It is not kid friendly and has a customer rating of 1 out of 5.
"name[The Punter], eatType[restaurant], food[Indian], priceRange[moderate], customer rating[1 out of 5], area[city centre], familyFriendly[yes], near[Express by Holiday Inn]"	The Punter is an indian restaurant with a moderate price range. It is located in the city centre near Express by Holiday Inn. It is kid friendly and has a customer rating of 1 out of 5.
"name[The Punter], eatType[restaurant], food[Indian], priceRange[moderate], customer rating[1 out of 5], area[riverside], familyFriendly[no], near[Express by Holiday Inn]"	The Punter is a moderately priced indian restaurant located in the riverside area near Express by Holiday Inn. It has a customer rating of 1 out of 5 and is not kid friendly.
"name[The Punter], eatType[restaurant], food[Indian], priceRange[moderate], customer rating[1 out of 5], area[riverside], familyFriendly[yes], near[Express by Holiday Inn]"	The Punter is an indian restaurant with a moderate price range. It is located in the riverside. It is near Express by Holiday Inn. Its customer rating is 1 out of 5 and is kid friendly.
"name[The Punter], eatType[restaurant], food[Indian], priceRange[moderate], customer rating[3 out of 5], area[city centre], familyFriendly[no], near[Express by Holiday Inn]"	The Punter is an indian restaurant located in the city centre near Express by Holiday Inn. It is not kid friendly and has a moderate price range and a customer rating of 3 out of 5.
"name[The Punter], eatType[restaurant], food[Indian], priceRange[moderate], customer rating[3 out of 5], area[city centre], familyFriendly[yes], near[Express by Holiday Inn]"	The Punter is an indian restaurant with a moderate price range. It is located in the city centre near Express by Holiday Inn. It is kid friendly and has a customer rating of 3 out of 5.
"name[The Punter], eatType[restaurant], food[Indian], priceRange[moderate], customer rating[3 out of 5], area[riverside], familyFriendly[no], near[Express by Holiday Inn]"	The Punter is an indian restaurant located near Express by Holiday Inn in the riverside area. It has a moderate price range and a customer rating of 3 out of 5.
"name[The Punter], eatType[restaurant], food[Indian], priceRange[moderate], customer rating[3 out of 5], area[riverside], familyFriendly[yes], near[Express by Holiday Inn]"	The Punter is an indian restaurant with a moderate price range. It is located in the riverside. It is near Express by Holiday Inn. Its customer rating is 3 out of 5 and is kid friendly.
"name[The Punter], eatType[restaurant], food[Indian], priceRange[more than £30], customer rating[high], area[city centre], familyFriendly[no], near[Express by Holiday Inn]"	The Punter is an indian restaurant located in the city centre near Express by Holiday Inn. It has a high customer rating and is not child friendly and has a price range of more than £30.
"name[The Punter], eatType[restaurant], food[Indian], priceRange[more than £30], customer rating[high], area[city centre], familyFriendly[yes], near[Express by Holiday Inn]"	The Punter is an indian restaurant located in the city centre near Express by Holiday Inn. It has a high customer rating and is children friendly and has a price range of more than £30.
"name[The Punter], eatType[restaurant], food[Indian], priceRange[more than £30], customer rating[high], area[riverside], familyFriendly[no], near[Express by Holiday Inn]"	The Punter is an indian restaurant located near Express by Holiday Inn in the riverside area. It has a high customer rating and a price range of more than £30 and is not child friendly.
"name[The Punter], eatType[restaurant], food[Indian], priceRange[more than £30], customer rating[high], area[riverside], familyFriendly[yes], near[Express by Holiday Inn]"	The Punter is an indian restaurant with a high customer rating. It is located in the riverside area near Express by Holiday Inn. It is children friendly and has a price range of more than £30.
"name[The Punter], eatType[restaurant], food[Italian], priceRange[£20-25], customer rating[high], area[city centre], familyFriendly[no], near[Express by Holiday Inn]"	The Punter is an italian restaurant located in the city centre near Express by Holiday Inn. It is not kid friendly and has a high customer rating and a price range of £20-25.
"name[The Punter], eatType[restaurant], food[Italian], priceRange[£20-25], customer rating[high], area[city centre], familyFriendly[yes], near[Express by Holiday Inn]"	The Punter is an italian restaurant located in the city centre near Express by Holiday Inn. It is kid friendly and has a high customer rating and a price range of £20-25.
"name[The Punter], eatType[restaurant], food[Italian], priceRange[£20-25], customer rating[high], area[riverside], familyFriendly[no], near[Express by Holiday Inn]"	The Punter is an italian restaurant located near Express by Holiday Inn in the riverside area. It has a high customer rating and a price range of £20-25 and is not kid friendly.
"name[The Punter], eatType[restaurant], food[Italian], priceRange[£20-25], customer rating[high], area[riverside], familyFriendly[yes], near[Express by Holiday Inn]"	The Punter is an italian restaurant near Express by Holiday Inn. It is highly rated by customers. It is kid friendly and has a price range of £20-25.
"name[The Punter], eatType[restaurant], food[Italian], priceRange[cheap], customer rating[5 out of 5], area[city centre], familyFriendly[no], near[Express by Holiday Inn]"	The Punter is a cheap italian restaurant in the city centre near Express by Holiday Inn. It is not family-friendly and has a customer rating of 5 out of 5.
"name[The Punter], eatType[restaurant], food[Italian], priceRange[cheap], customer rating[5 out of 5], area[city centre], familyFriendly[no], near[Rainbow Vegetarian Café]"	The Punter is a cheap italian restaurant in the city centre near Rainbow Vegetarian Café. It is not family-friendly and has a customer rating of 5 out of 5.
"name[The Punter], eatType[restaurant], food[Italian], priceRange[cheap], customer rating[5 out of 5], area[city centre], familyFriendly[yes], near[Rainbow Vegetarian Café]"	The Punter is a family-friendly italian restaurant located near Rainbow Vegetarian Café in the city centre. It has a customer rating of 5 out of 5 and a cheap price range.
"name[The Punter], eatType[restaurant], food[Italian], priceRange[cheap], customer rating[5 out of 5], area[riverside], familyFriendly[no], near[Rainbow Vegetarian Café]"	The Punter is a cheap italian restaurant near Rainbow Vegetarian Café in the riverside area. It has a customer rating of 5 out of 5 and is not family-friendly.
"name[The Punter], eatType[restaurant], food[Italian], priceRange[cheap], customer rating[5 out of 5], area[riverside], familyFriendly[yes], near[Rainbow Vegetarian Café]"	The Punter is a family-friendly italian restaurant located near Rainbow Vegetarian Café in the riverside area. It has a customer rating of 5 out of 5 and a cheap price range.
"name[The Punter], eatType[restaurant], food[Italian], priceRange[cheap], customer rating[average], area[city centre], familyFriendly[no], near[Rainbow Vegetarian Café]"	The Punter is an italian restaurant located near Rainbow Vegetarian Café in the city centre. It is not family-friendly and has an average customer rating.
"name[The Punter], eatType[restaurant], food[Italian], priceRange[cheap], customer rating[average], area[city centre], familyFriendly[yes], near[Rainbow Vegetarian Café]"	The Punter is a family-friendly italian restaurant located in the city centre near Rainbow Vegetarian Café. It has an average customer rating and a cheap price range.
"name[The Punter], eatType[restaurant], food[Italian], priceRange[cheap], customer rating[average], area[riverside], familyFriendly[no], near[Rainbow Vegetarian Café]"	The Punter is an italian restaurant located near Rainbow Vegetarian Café in the riverside area. It is not family-friendly and has an average customer rating. It is cheap.
"name[The Punter], eatType[restaurant], food[Italian], priceRange[cheap], customer rating[average], area[riverside], familyFriendly[yes], near[Rainbow Vegetarian Café]"	The Punter is a family friendly italian restaurant located near Rainbow Vegetarian Café in the riverside area. It has an average customer rating and a cheap price range.
"name[The Punter], eatType[restaurant], food[Italian], priceRange[high], customer rating[1 out of 5], area[city centre], familyFriendly[no], near[Rainbow Vegetarian Café]"	The Punter is an italian restaurant located near Rainbow Vegetarian Café in the city centre. It is not child friendly and has a customer rating of 1 out of 5.
"name[The Punter], eatType[restaurant], food[Italian], priceRange[high], customer rating[1 out of 5], area[city centre], familyFriendly[yes], near[Rainbow Vegetarian Café]"	The Punter is a child-friendly italian restaurant located in the city centre near Rainbow Vegetarian Café. It has a customer rating of 1 out of 5 and a high price range.
"name[The Punter], eatType[restaurant], food[Italian], priceRange[high], customer rating[1 out of 5], area[riverside], familyFriendly[no], near[Rainbow Vegetarian Café]"	The Punter is an italian restaurant located near Rainbow Vegetarian Café in the riverside area. It is not child friendly and has a customer rating of 1 out of 5.
"name[The Punter], eatType[restaurant], food[Italian], priceRange[high], customer rating[1 out of 5], area[riverside], familyFriendly[yes], near[Rainbow Vegetarian Café]"	The Punter is an italian restaurant located near Rainbow Vegetarian Café in the riverside area. It is child friendly and has a customer rating of 1 out of 5 and a high price range.
"name[The Vaults], eatType[pub], food[French], priceRange[high], area[riverside], familyFriendly[yes], near[Raja Indian Cuisine]"	The Vaults is a pub that serves french food. It is located near Raja Indian Cuisine in the riverside area. It is child friendly and has a high price range.
"name[The Vaults], eatType[pub], food[French], priceRange[less than £20], area[city centre], familyFriendly[no], near[Raja Indian Cuisine]"	The Vaults is a french pub in the city centre near Raja Indian Cuisine. It is not family-friendly and has a price range of less than £20.
"name[The Vaults], eatType[pub], food[French], priceRange[less than £20], area[city centre], familyFriendly[yes], near[Raja Indian Cuisine]"	The Vaults is a family-friendly pub that serves french food. It is located in the city centre near Raja Indian Cuisine. It has a price range of less than £20.
"name[The Vaults], eatType[pub], food[French], priceRange[less than £20], area[riverside], familyFriendly[no], near[Raja Indian Cuisine]"	The Vaults is a pub that serves french food. It is located near Raja Indian Cuisine in the riverside area. It is not family-friendly and has a price range of less than £20.
"name[The Vaults], eatType[pub], food[French], priceRange[less than £20], area[riverside], familyFriendly[yes], near[Raja Indian Cuisine]"	The Vaults is a family-friendly pub that serves french food. It is located near Raja Indian Cuisine in the riverside area. The price range is less than £20.
"name[The Vaults], eatType[pub], food[French], priceRange[moderate], area[city centre], familyFriendly[no], near[Raja Indian Cuisine]"	The Vaults is a pub that serves french food. It is located in the city centre near Raja Indian Cuisine. It is not kid friendly and has a moderate price range.
"name[The Vaults], eatType[pub], food[French], priceRange[moderate], area[city centre], familyFriendly[yes], near[Raja Indian Cuisine]"	The Vaults is a pub that serves french food. It is located in the city centre near Raja Indian Cuisine. It is kid friendly and has a moderate price range.
"name[The Vaults], eatType[pub], food[French], priceRange[moderate], area[riverside], familyFriendly[no], near[Raja Indian Cuisine]"	The Vaults is a pub that serves french food. It is located near Raja Indian Cuisine in the riverside area. It is not kid friendly and has a moderate price range.
"name[The Vaults], eatType[pub], food[French], priceRange[moderate], area[riverside], familyFriendly[yes], near[Raja Indian Cuisine]"	The Vaults is a pub that serves french food. It is located near Raja Indian Cuisine in the riverside area. It is kids friendly and has a moderate price range.
"name[The Vaults], eatType[pub], food[French], priceRange[more than £30], area[city centre], familyFriendly[no], near[Raja Indian Cuisine]"	The Vaults is a french pub in the city centre near Raja Indian Cuisine. It is not child friendly and has a price range of more than £30.
"name[The Vaults], eatType[pub], food[French], priceRange[more than £30], area[city centre], familyFriendly[yes], near[Raja Indian Cuisine]"	The Vaults is a pub that serves french food. It is located in the city centre near Raja Indian Cuisine. It is children friendly and has a price range of more than £30.
"name[The Vaults], eatType[pub], food[French], priceRange[more than £30], area[riverside], familyFriendly[no], near[Raja Indian Cuisine]"	The Vaults is a french pub near Raja Indian Cuisine in the riverside area. It is not child friendly and has a price range of more than £30.
"name[The Vaults], eatType[pub], food[French], priceRange[more than £30], area[riverside], familyFriendly[yes], near[Raja Indian Cuisine]"	The Vaults is a pub that serves french food. It is located near Raja Indian Cuisine in the riverside area. It is child friendly and has a price range of more than £30.
"name[The Vaults], eatType[pub], food[Indian], priceRange[£20-25], area[riverside], familyFriendly[yes], near[Raja Indian Cuisine]"	The Vaults is a pub that serves indian food in the riverside area near Raja Indian Cuisine. It is kid friendly and has a price range of £20-25.
"name[The Vaults], eatType[pub], food[Indian], priceRange[cheap], area[riverside], familyFriendly[yes], near[Raja Indian Cuisine]"	The Vaults is a family friendly pub that serves indian food. It is located in the riverside area near Raja Indian Cuisine. It has a cheap price range.
"name[The Vaults], eatType[pub], food[Indian], priceRange[high], area[city centre], familyFriendly[no], near[Raja Indian Cuisine]"	The Vaults is a pub that serves indian food in the high price range. It is located in the city centre near Raja Indian Cuisine. It is not children friendly.
"name[The Vaults], eatType[pub], food[Indian], priceRange[high], area[city centre], familyFriendly[yes], near[Raja Indian Cuisine]"	The Vaults is a pub that serves indian food in the high price range. It is located in the city centre near Raja Indian Cuisine and is children friendly.
"name[The Vaults], eatType[pub], food[Italian], priceRange[high], customer rating[average], area[city centre], familyFriendly[no], near[Rainbow Vegetarian Café]"	The Vaults is an italian pub located near Rainbow Vegetarian Café in the city centre. It is not child friendly and has an average customer rating.
"name[The Vaults], eatType[pub], food[Italian], priceRange[high], customer rating[average], area[city centre], familyFriendly[yes], near[Rainbow Vegetarian Café]"	The Vaults is an italian pub near Rainbow Vegetarian Café in the city centre. It is children friendly and has a high price range and an average customer rating.
"name[The Vaults], eatType[pub], food[Italian], priceRange[high], customer rating[average], area[riverside], familyFriendly[no], near[Rainbow Vegetarian Café]"	The Vaults is an italian pub located near Rainbow Vegetarian Café in the riverside area. It is not child friendly and has an average customer rating.
"name[The Vaults], eatType[pub], food[Italian], priceRange[high], customer rating[average], area[riverside], familyFriendly[yes], near[Rainbow Vegetarian Café]"	The Vaults is a pub that serves italian food. It is located near Rainbow Vegetarian Café in the riverside area. It is children friendly and has an average customer rating.
"name[The Vaults], eatType[pub], food[Italian], priceRange[less than £20], customer rating[low], area[city centre], familyFriendly[no], near[Rainbow Vegetarian Café]"	The Vaults is an italian pub in the city centre near Rainbow Vegetarian Café. It is not family-friendly and has a low customer rating. It has a price range of less than £20.
"name[The Vaults], eatType[pub], food[Italian], priceRange[less than £20], customer rating[low], area[city centre], familyFriendly[yes], near[Rainbow Vegetarian Café]"	The Vaults is a family-friendly pub that serves italian food. It is located in the city centre near Rainbow Vegetarian Café. It has a low customer rating and a price range of less than £20.
"name[The Vaults], eatType[pub], food[Italian], priceRange[less than £20], customer rating[low], area[riverside], familyFriendly[no], near[Rainbow Vegetarian Café]"	The Vaults is an italian pub near Rainbow Vegetarian Café in the riverside area. It is not family-friendly and has a low customer rating and a price range of less than £20.
"name[The Vaults], eatType[pub], food[Italian], priceRange[less than £20], customer rating[low], area[riverside], familyFriendly[yes], near[Rainbow Vegetarian Café]"	The Vaults is a family-friendly pub that serves italian food. It is located near Rainbow Vegetarian Café in the riverside area. It has a low customer rating and a price range of less than £20.
"name[The Vaults], eatType[pub], food[Italian], priceRange[moderate], customer rating[1 out of 5], area[city centre], familyFriendly[no], near[Rainbow Vegetarian Café]"	The Vaults is an italian pub located near Rainbow Vegetarian Café in the city centre. It is not kid friendly and has a customer rating of 1 out of 5.
"name[The Vaults], eatType[pub], food[Italian], priceRange[moderate], customer rating[1 out of 5], area[city centre], familyFriendly[yes], near[Rainbow Vegetarian Café]"	The Vaults is an italian pub in the city centre near Rainbow Vegetarian Café. It is kid friendly and has a moderate price range and a customer rating of 1 out of 5.
"name[The Vaults], eatType[pub], food[Italian], priceRange[moderate], customer rating[1 out of 5], area[riverside], familyFriendly[no], near[Rainbow Vegetarian Café]"	The Vaults is an italian pub located near Rainbow Vegetarian Café in the riverside area. It is not kid friendly and has a customer rating of 1 out of 5.
"name[The Vaults], eatType[pub], food[Italian], priceRange[moderate], customer rating[1 out of 5], area[riverside], familyFriendly[yes], near[Rainbow Vegetarian Café]"	The Vaults is an italian pub near Rainbow Vegetarian Café in the riverside area. It is kid friendly and has a moderate price range and a customer rating of 1 out of 5.
"name[The Vaults], eatType[pub], food[Italian], priceRange[moderate], customer rating[3 out of 5], area[city centre], familyFriendly[no], near[Rainbow Vegetarian Café]"	The Vaults is an italian pub located near Rainbow Vegetarian Café in the city centre. It is not kid friendly and has a moderate price range and a customer rating of 3 out of 5.
"name[The Vaults], eatType[pub], food[Italian], priceRange[moderate], customer rating[3 out of 5], area[city centre], familyFriendly[yes], near[Rainbow Vegetarian Café]"	The Vaults is a moderately priced italian pub in the city centre near Rainbow Vegetarian Café. It is kid friendly and has a customer rating of 3 out of 5.
"name[The Vaults], eatType[pub], food[Italian], priceRange[moderate], customer rating[3 out of 5], area[riverside], familyFriendly[no], near[Rainbow Vegetarian Café]"	The Vaults is an italian pub located near Rainbow Vegetarian Café in the riverside area. It is not kid friendly and has a moderate price range and a customer rating of 3 out of 5.
"name[The Vaults], eatType[pub], food[Italian], priceRange[moderate], customer rating[3 out of 5], area[riverside], familyFriendly[yes], near[Rainbow Vegetarian Café]"	"The Vaults is a moderately priced, italian pub, located near Rainbow Vegetarian Café in the riverside area. It has a customer rating of 3 out of 5 and is kid friendly."
"name[The Vaults], eatType[pub], food[Italian], priceRange[more than £30], customer rating[high], area[city centre], familyFriendly[no], near[Rainbow Vegetarian Café]"	The Vaults is a highly rated italian pub in the city centre near Rainbow Vegetarian Café. It is not child friendly and has a price range of more than £30.
"name[The Vaults], eatType[pub], food[Italian], priceRange[more than £30], customer rating[high], area[city centre], familyFriendly[yes], near[Rainbow Vegetarian Café]"	The Vaults is a highly rated italian pub in the city centre near Rainbow Vegetarian Café. It is children friendly and has a price range of more than £30.
"name[The Vaults], eatType[pub], food[Italian], priceRange[more than £30], customer rating[high], area[riverside], familyFriendly[no], near[Rainbow Vegetarian Café]"	The Vaults is a highly rated italian pub near Rainbow Vegetarian Café in the riverside area. It is not child friendly and has a price range of more than £30.
"name[The Vaults], eatType[pub], food[Italian], priceRange[more than £30], customer rating[high], area[riverside], familyFriendly[yes], near[Rainbow Vegetarian Café]"	The Vaults is a pub that serves italian food. It is located near Rainbow Vegetarian Café in the riverside area. It is child friendly and has a high customer rating and a price range of more than £30.
"name[The Vaults], eatType[pub], food[Japanese], priceRange[£20-25], customer rating[3 out of 5], area[city centre], familyFriendly[no], near[Rainbow Vegetarian Café]"	The Vaults is a japanese pub in the city centre near Rainbow Vegetarian Café. It is not kid friendly and has a customer rating of 3 out of 5. It has a price range of £20-25.
"name[The Vaults], eatType[pub], food[Japanese], priceRange[£20-25], customer rating[3 out of 5], area[city centre], familyFriendly[yes], near[Rainbow Vegetarian Café]"	The Vaults is a japanese pub in the city centre near Rainbow Vegetarian Café. It is kid friendly and has a customer rating of 3 out of 5 and a price range of £20-25.
"name[The Vaults], eatType[pub], food[Japanese], priceRange[£20-25], customer rating[3 out of 5], area[riverside], familyFriendly[no], near[Rainbow Vegetarian Café]"	The Vaults is a japanese pub near Rainbow Vegetarian Café in the riverside area. It is not kid friendly and has a customer rating of 3 out of 5 and a price range of £20-25.
"name[The Vaults], eatType[pub], food[Japanese], priceRange[£20-25], customer rating[3 out of 5], area[riverside], familyFriendly[yes], near[Rainbow Vegetarian Café]"	The Vaults is a japanese pub near Rainbow Vegetarian Café in the riverside area. It is kid friendly and has a customer rating of 3 out of 5 and a price range of £20-25.
"name[The Vaults], eatType[pub], food[Japanese], priceRange[£20-25], customer rating[high], area[city centre], familyFriendly[no], near[Rainbow Vegetarian Café]"	The Vaults is a highly rated pub in the city centre near Rainbow Vegetarian Café. It is not kid friendly and serves japanese food in the £20-25 price range.
"name[The Vaults], eatType[pub], food[Japanese], priceRange[£20-25], customer rating[high], area[city centre], familyFriendly[yes], near[Rainbow Vegetarian Café]"	The Vaults is a highly rated pub in the city centre near Rainbow Vegetarian Café. They serve japanese food and is kid friendly. The price range is £20-25.
"name[The Vaults], eatType[pub], food[Japanese], priceRange[£20-25], customer rating[high], area[riverside], familyFriendly[no], near[Rainbow Vegetarian Café]"	The Vaults is a pub that serves japanese food. It is located near Rainbow Vegetarian Café in the riverside area. It has a high customer rating and a price range of £20-25 and is not child friendly.
"name[The Vaults], eatType[pub], food[Japanese], priceRange[£20-25], customer rating[high], area[riverside], familyFriendly[no], near[Raja Indian Cuisine]"	The Vaults is a pub that serves japanese food. It is located near Raja Indian Cuisine in the riverside area. It has a high customer rating and a price range of £20-25 and is not child friendly.
"name[The Vaults], eatType[pub], food[Japanese], priceRange[£20-25], customer rating[high], area[riverside], familyFriendly[yes], near[Raja Indian Cuisine]"	"The Vaults is a highly rated, kid friendly pub serving japanese food. It is located near Raja Indian Cuisine in the riverside area and has a price range of £20-25."
"name[The Vaults], eatType[pub], food[Japanese], priceRange[cheap], customer rating[5 out of 5], area[city centre], familyFriendly[no], near[Raja Indian Cuisine]"	The Vaults is a cheap pub in the city centre near Raja Indian Cuisine. It is not family-friendly and has a customer rating of 5 out of 5.
"name[The Vaults], eatType[pub], food[Japanese], priceRange[cheap], customer rating[5 out of 5], area[city centre], familyFriendly[yes], near[Raja Indian Cuisine]"	The Vaults is a family-friendly pub that serves japanese food. It is located in the city centre near Raja Indian Cuisine. It has a customer rating of 5 out of 5 and a cheap price range.
"name[The Vaults], eatType[pub], food[Japanese], priceRange[cheap], customer rating[5 out of 5], area[riverside], familyFriendly[no], near[Raja Indian Cuisine]"	The Vaults is a cheap japanese pub near Raja Indian Cuisine in the riverside area. It has a customer rating of 5 out of 5 and is not family-friendly.
"name[The Vaults], eatType[pub], food[Japanese], priceRange[cheap], customer rating[5 out of 5], area[riverside], familyFriendly[yes], near[Raja Indian Cuisine]"	The Vaults is a cheap pub near Raja Indian Cuisine. It is a family friendly pub with a 5 out of 5 rating.
"name[The Vaults], eatType[pub], food[Japanese], priceRange[high], customer rating[3 out of 5], area[city centre], familyFriendly[no], near[Raja Indian Cuisine]"	The Vaults is a japanese pub near Raja Indian Cuisine in the city centre. It is not child friendly and has a customer rating of 3 out of 5 and a high price range.
"name[The Vaults], eatType[pub], food[Japanese], priceRange[high], customer rating[3 out of 5], area[city centre], familyFriendly[yes], near[Raja Indian Cuisine]"	The Vaults is a pub that serves japanese food. It is located near Raja Indian Cuisine in the city centre. It has a customer rating of 3 out of 5 and is child friendly. It is in the high price range.
"name[The Vaults], eatType[pub], food[Japanese], priceRange[high], customer rating[3 out of 5], area[riverside], familyFriendly[no], near[Raja Indian Cuisine]"	The Vaults is a pub that serves japanese food. It is located near Raja Indian Cuisine in the riverside area. It is not child friendly and has a customer rating of 3 out of 5.
"name[The Vaults], eatType[pub], food[Japanese], priceRange[high], customer rating[3 out of 5], area[riverside], familyFriendly[yes], near[Raja Indian Cuisine]"	The Vaults is a pub that serves japanese food. It is located near Raja Indian Cuisine in the riverside area. It is child friendly and has a customer rating of 3 out of 5.
"name[The Vaults], eatType[pub], food[Japanese], priceRange[less than £20], customer rating[average], area[city centre], familyFriendly[no], near[Raja Indian Cuisine]"	The Vaults is a pub that serves japanese food. It is located near Raja Indian Cuisine in the city centre. It is not family-friendly and has an average customer rating. It has a price range of less than £20.
"name[The Vaults], eatType[pub], food[Japanese], priceRange[less than £20], customer rating[average], area[city centre], familyFriendly[yes], near[Raja Indian Cuisine]"	The Vaults is a family-friendly pub that serves japanese food. It is located near Raja Indian Cuisine in the city centre. It has an average customer rating and a price range of less than £20.
"name[The Vaults], eatType[pub], food[Japanese], priceRange[less than £20], customer rating[average], area[riverside], familyFriendly[no], near[Raja Indian Cuisine]"	The Vaults is a pub that serves japanese food. It is located near Raja Indian Cuisine in the riverside area. It is not family-friendly and has an average customer rating. It has a price range of less than £20.
"name[The Vaults], eatType[pub], food[Japanese], priceRange[less than £20], customer rating[average], area[riverside], familyFriendly[yes], near[Raja Indian Cuisine]"	The Vaults is a family-friendly pub that serves japanese food. It is located near Raja Indian Cuisine in the riverside area. It has an average customer rating and a price range of less than £20.
"name[The Vaults], eatType[pub], food[Japanese], priceRange[less than £20], customer rating[low], area[city centre], familyFriendly[no], near[Raja Indian Cuisine]"	The Vaults is a pub that serves japanese food. It is located near Raja Indian Cuisine in the city centre. It is not family-friendly and has a low customer rating.
"name[The Vaults], eatType[pub], food[Japanese], priceRange[less than £20], customer rating[low], area[city centre], familyFriendly[yes], near[Raja Indian Cuisine]"	The Vaults is a family-friendly pub that serves japanese food. It is located in the city centre near Raja Indian Cuisine. It has a low customer rating and a price range of less than £20.
"name[The Vaults], eatType[pub], food[Japanese], priceRange[less than £20], customer rating[low], area[riverside], familyFriendly[no], near[Raja Indian Cuisine]"	The Vaults is a pub that serves japanese food. It is located near Raja Indian Cuisine in the riverside area. It is not family-friendly and has a low customer rating.
"name[The Vaults], eatType[pub], food[Japanese], priceRange[less than £20], customer rating[low], area[riverside], familyFriendly[yes], near[Raja Indian Cuisine]"	The Vaults is a family friendly pub that serves japanese food. It is located near Raja Indian Cuisine in the riverside area. It has a low customer rating and a price range of less than £20.
"name[The Vaults], eatType[pub], food[Japanese], priceRange[moderate], customer rating[1 out of 5], area[city centre], familyFriendly[no], near[Raja Indian Cuisine]"	The Vaults is a pub that serves japanese food. It is located near Raja Indian Cuisine in the city centre. It has a moderate price range and a customer rating of 1 out of 5.
"name[The Vaults], eatType[pub], food[Japanese], priceRange[moderate], customer rating[1 out of 5], area[city centre], familyFriendly[yes], near[Raja Indian Cuisine]"	The Vaults is a pub that serves japanese food. It is located in the city centre near Raja Indian Cuisine. It is kid friendly and has a customer rating of 1 out of 5.
"name[The Vaults], eatType[restaurant], food[French], priceRange[high], area[riverside], familyFriendly[yes], near[Raja Indian Cuisine]"	The Vaults is a french restaurant located near Raja Indian Cuisine in the riverside area. It is child friendly and has a high price range.
"name[The Vaults], eatType[restaurant], food[French], priceRange[less than £20], area[city centre], familyFriendly[no], near[Raja Indian Cuisine]"	The Vaults is a french restaurant located in the city centre near Raja Indian Cuisine. It is not family-friendly and has a price range of less than £20.
"name[The Vaults], eatType[restaurant], food[French], priceRange[less than £20], area[city centre], familyFriendly[yes], near[Raja Indian Cuisine]"	The Vaults is a family-friendly french restaurant located in the city centre near Raja Indian Cuisine. It has a price range of less than £20.
"name[The Vaults], eatType[restaurant], food[French], priceRange[less than £20], area[riverside], familyFriendly[no], near[Raja Indian Cuisine]"	The Vaults is a french restaurant located near Raja Indian Cuisine in the riverside area. It is not family-friendly and has a price range of less than £20.
"name[The Vaults], eatType[restaurant], food[French], priceRange[less than £20], area[riverside], familyFriendly[yes], near[Raja Indian Cuisine]"	The Vaults is a family-friendly restaurant that serves french food. It is located near Raja Indian Cuisine in the riverside area. The price range is less than £20.
"name[The Vaults], eatType[restaurant], food[French], priceRange[moderate], area[city centre], familyFriendly[no], near[Raja Indian Cuisine]"	The Vaults is a french restaurant located in the city centre near Raja Indian Cuisine. It is not kid friendly and has a moderate price range.
"name[The Vaults], eatType[restaurant], food[French], priceRange[moderate], area[city centre], familyFriendly[yes], near[Raja Indian Cuisine]"	The Vaults is a kid-friendly french restaurant located in the city centre near Raja Indian Cuisine. It has a moderate price range.
"name[The Vaults], eatType[restaurant], food[French], priceRange[moderate], area[riverside], familyFriendly[no], near[Raja Indian Cuisine]"	The Vaults is a french restaurant located near Raja Indian Cuisine in the riverside area. It is not kid friendly and has a moderate price range.
"name[The Vaults], eatType[restaurant], food[French], priceRange[moderate], area[riverside], familyFriendly[yes], near[Raja Indian Cuisine]"	The Vaults is a kid friendly french restaurant located near Raja Indian Cuisine in the riverside area. It has a moderate price range.
"name[The Vaults], eatType[restaurant], food[French], priceRange[more than £30], area[city centre], familyFriendly[no], near[Raja Indian Cuisine]"	The Vaults is a french restaurant located in the city centre near Raja Indian Cuisine. It is not child friendly and has a price range of more than £30.
"name[The Vaults], eatType[restaurant], food[French], priceRange[more than £30], area[city centre], familyFriendly[yes], near[Raja Indian Cuisine]"	The Vaults is a french restaurant located in the city centre near Raja Indian Cuisine. It is children friendly and has a price range of more than £30.
"name[The Vaults], eatType[restaurant], food[French], priceRange[more than £30], area[riverside], familyFriendly[no], near[Raja Indian Cuisine]"	The Vaults is a french restaurant located near Raja Indian Cuisine in the riverside area. It is not child friendly and has a price range of more than £30.
"name[The Vaults], eatType[restaurant], food[French], priceRange[more than £30], area[riverside], familyFriendly[yes], near[Raja Indian Cuisine]"	The Vaults is a french restaurant located near Raja Indian Cuisine in the riverside area. It is child friendly and has a price range of more than £30.
"name[The Vaults], eatType[restaurant], food[Indian], priceRange[£20-25], area[riverside], familyFriendly[yes], near[Raja Indian Cuisine]"	The Vaults is an indian restaurant located near Raja Indian Cuisine in the riverside area. It is kid friendly and has a price range of £20-25.
"name[The Vaults], eatType[restaurant], food[Indian], priceRange[cheap], area[riverside], familyFriendly[yes], near[Raja Indian Cuisine]"	The Vaults is a family friendly indian restaurant near Raja Indian Cuisine in the riverside area. The price range is cheap.
"name[The Vaults], eatType[restaurant], food[Indian], priceRange[high], area[city centre], familyFriendly[no], near[Raja Indian Cuisine]"	The Vaults is an indian restaurant located in the city centre near Raja Indian Cuisine. It is not child friendly and has a high price range.
"name[The Vaults], eatType[restaurant], food[Indian], priceRange[high], area[city centre], familyFriendly[yes], near[Raja Indian Cuisine]"	The Vaults is an indian restaurant located in the city centre near Raja Indian Cuisine. It is child friendly and has a high price range.
"name[The Waterman], eatType[pub], food[Indian], priceRange[high], area[city centre], familyFriendly[yes], near[Raja Indian Cuisine]"	The Waterman is a pub that serves indian food in the high price range. It is located in the city centre near Raja Indian Cuisine and is children friendly.
"name[The Waterman], eatType[pub], food[Indian], priceRange[high], area[riverside], familyFriendly[no], near[Raja Indian Cuisine]"	The Waterman is a pub that serves indian food. It is located near Raja Indian Cuisine in the riverside area. It is not child friendly and has a high price range.
"name[The Waterman], eatType[pub], food[Indian], priceRange[high], area[riverside], familyFriendly[yes], near[Raja Indian Cuisine]"	The Waterman is a pub that serves indian food. It is located near Raja Indian Cuisine in the riverside area. It is children friendly and has a high price range.
"name[The Waterman], eatType[pub], food[Indian], priceRange[less than £20], area[city centre], familyFriendly[no], near[Raja Indian Cuisine]"	"The Waterman is a pub that serves indian food in the less than £20 price range. It is located in the city centre, near Raja Indian Cuisine. It is not family friendly."
"name[The Waterman], eatType[pub], food[Indian], priceRange[less than £20], area[city centre], familyFriendly[yes], near[Raja Indian Cuisine]"	The Waterman is a family friendly pub that serves indian food in the less than £20 price range. It is located in the city centre near Raja Indian Cuisine.
"name[The Waterman], eatType[pub], food[Indian], priceRange[less than £20], area[riverside], familyFriendly[no], near[Raja Indian Cuisine]"	The Waterman is a pub that serves indian food for less than £20. It is located near Raja Indian Cuisine in the riverside area. It is not family friendly.
"name[The Waterman], eatType[pub], food[Indian], priceRange[less than £20], area[riverside], familyFriendly[yes], near[Raja Indian Cuisine]"	The Waterman is a family friendly indian pub near Raja Indian Cuisine in the riverside area with a price range of less than £20.
"name[The Waterman], eatType[pub], food[Indian], priceRange[moderate], area[city centre], familyFriendly[no], near[Raja Indian Cuisine]"	"The Waterman is a pub that serves indian food in the moderate price range. It is located in the city centre, near Raja Indian Cuisine. It is not kid friendly."
"name[The Waterman], eatType[pub], food[Indian], priceRange[moderate], area[city centre], familyFriendly[yes], near[Raja Indian Cuisine]"	The Waterman is a pub that serves indian food in the moderate price range. It is located in the city centre near Raja Indian Cuisine and is kid friendly.
"name[The Waterman], eatType[pub], food[Indian], priceRange[moderate], area[riverside], familyFriendly[no], near[Raja Indian Cuisine]"	The Waterman is a pub that serves indian food in the riverside area near Raja Indian Cuisine. It is not kid friendly and has a moderate price range.
"name[The Waterman], eatType[pub], food[Indian], priceRange[moderate], area[riverside], familyFriendly[yes], near[Raja Indian Cuisine]"	The Waterman is a pub that serves indian food. It is located near Raja Indian Cuisine in the riverside area. It is kid friendly and has a moderate price range.
"name[The Waterman], eatType[pub], food[Indian], priceRange[more than £30], area[riverside], familyFriendly[yes], near[Raja Indian Cuisine]"	The Waterman is an indian pub near Raja Indian Cuisine in the riverside area. It is children friendly and has a price range of more than £30.
"name[The Waterman], eatType[pub], food[Italian], priceRange[£20-25], area[riverside], familyFriendly[yes], near[Raja Indian Cuisine]"	The Waterman is a kid friendly pub that serves italian food. It is located near Raja Indian Cuisine in the riverside area and has a price range of £20-25.
"name[The Waterman], eatType[pub], food[Italian], priceRange[cheap], area[riverside], familyFriendly[yes], near[Raja Indian Cuisine]"	The Waterman is a family friendly pub near Raja Indian Cuisine in the riverside area. It serves italian food and has a cheap price range.
"name[The Waterman], eatType[pub], food[Italian], priceRange[high], area[city centre], familyFriendly[no], near[Raja Indian Cuisine]"	The Waterman is an italian pub located near Raja Indian Cuisine in the city centre. It is not child friendly and has a high price range.
"name[The Waterman], eatType[pub], food[Italian], priceRange[high], area[city centre], familyFriendly[yes], near[Raja Indian Cuisine]"	The Waterman is a pub that serves italian food. It is located in the city centre near Raja Indian Cuisine. It is children friendly and has a high price range.
"name[The Waterman], eatType[pub], food[Italian], priceRange[high], area[riverside], familyFriendly[no], near[Raja Indian Cuisine]"	The Waterman is an italian pub located near Raja Indian Cuisine in the riverside area. It is not child friendly and has a high price range.
"name[The Waterman], eatType[pub], food[Italian], priceRange[high], area[riverside], familyFriendly[yes], near[Raja Indian Cuisine]"	The Waterman is a pub that serves italian food. It is located near Raja Indian Cuisine in the riverside area. It is child friendly and has a high price range.
"name[The Waterman], eatType[pub], food[Italian], priceRange[less than £20], area[city centre], familyFriendly[no], near[Raja Indian Cuisine]"	The Waterman is an italian pub near Raja Indian Cuisine in the city centre. It is not family-friendly and has a price range of less than £20.
"name[The Waterman], eatType[pub], food[Italian], priceRange[less than £20], area[city centre], familyFriendly[yes], near[Raja Indian Cuisine]"	The Waterman is a family-friendly italian pub in the city centre near Raja Indian Cuisine with a price range less than £20.
"name[The Waterman], eatType[pub], food[Italian], priceRange[less than £20], area[riverside], familyFriendly[no], near[Raja Indian Cuisine]"	The Waterman is an italian pub located near Raja Indian Cuisine in the riverside area. It is not family-friendly and has a price range of less than £20.
"name[The Waterman], eatType[restaurant], food[Indian], priceRange[high], area[city centre], familyFriendly[yes], near[Raja Indian Cuisine]"	The Waterman is an indian restaurant located in the city centre near Raja Indian Cuisine. It is child friendly and has a high price range.
"name[The Waterman], eatType[restaurant], food[Indian], priceRange[high], area[riverside], familyFriendly[no], near[Raja Indian Cuisine]"	The Waterman is an indian restaurant located near Raja Indian Cuisine in the riverside area. It is not child friendly and has a high price range.
"name[The Waterman], eatType[restaurant], food[Indian], priceRange[high], area[riverside], familyFriendly[yes], near[Raja Indian Cuisine]"	The Waterman is an indian restaurant located near Raja Indian Cuisine in the riverside area. It is child friendly and has a high price range.
"name[The Waterman], eatType[restaurant], food[Indian], priceRange[less than £20], area[city centre], familyFriendly[no], near[Raja Indian Cuisine]"	The Waterman is an indian restaurant located in the city centre near Raja Indian Cuisine. It is not family-friendly and has a price range of less than £20.
"name[The Waterman], eatType[restaurant], food[Indian], priceRange[less than £20], area[city centre], familyFriendly[yes], near[Raja Indian Cuisine]"	The Waterman is a family friendly indian restaurant located in the city centre near Raja Indian Cuisine with a price range less than £20.
"name[The Waterman], eatType[restaurant], food[Indian], priceRange[less than £20], area[riverside], familyFriendly[no], near[Raja Indian Cuisine]"	The Waterman is an indian restaurant located near Raja Indian Cuisine in the riverside area. It is not family friendly and has a price range of less than £20.
"name[The Waterman], eatType[restaurant], food[Indian], priceRange[less than £20], area[riverside], familyFriendly[yes], near[Raja Indian Cuisine]"	The Waterman is a family friendly indian restaurant near Raja Indian Cuisine in the riverside area with a price range of less than £20.
"name[The Waterman], eatType[restaurant], food[Indian], priceRange[moderate], area[city centre], familyFriendly[no], near[Raja Indian Cuisine]"	The Waterman is an indian restaurant located in the city centre near Raja Indian Cuisine. It is not kid friendly and has a moderate price range.
"name[The Waterman], eatType[restaurant], food[Indian], priceRange[moderate], area[city centre], familyFriendly[yes], near[Raja Indian Cuisine]"	The Waterman is an indian restaurant located in the city centre near Raja Indian Cuisine. It is kid friendly and has a moderate price range.
"name[The Waterman], eatType[restaurant], food[Indian], priceRange[moderate], area[riverside], familyFriendly[no], near[Raja Indian Cuisine]"	The Waterman is an indian restaurant located near Raja Indian Cuisine in the riverside area. It is not kid friendly and has a moderate price range.
"name[The Waterman], eatType[restaurant], food[Indian], priceRange[moderate], area[riverside], familyFriendly[yes], near[Raja Indian Cuisine]"	The Waterman is an indian restaurant located near Raja Indian Cuisine in the riverside area. It is kid friendly and has a moderate price range.
"name[The Waterman], eatType[restaurant], food[Indian], priceRange[more than £30], area[riverside], familyFriendly[yes], near[Raja Indian Cuisine]"	The Waterman is an indian restaurant located near Raja Indian Cuisine in the riverside area. It is children friendly and has a price range of more than £30.
"name[The Waterman], eatType[restaurant], food[Italian], priceRange[£20-25], area[riverside], familyFriendly[yes], near[Raja Indian Cuisine]"	The Waterman is a kid friendly italian restaurant near Raja Indian Cuisine in the riverside area with a price range of £20-25.
"name[The Waterman], eatType[restaurant], food[Italian], priceRange[cheap], area[riverside], familyFriendly[yes], near[Raja Indian Cuisine]"	The Waterman is a family friendly italian restaurant near Raja Indian Cuisine in the riverside area. The price range is cheap.
"name[The Waterman], eatType[restaurant], food[Italian], priceRange[high], area[city centre], familyFriendly[no], near[Raja Indian Cuisine]"	The Waterman is an italian restaurant located near Raja Indian Cuisine in the city centre. It is not child friendly and has a high price range.
"name[The Waterman], eatType[restaurant], food[Italian], priceRange[high], area[city centre], familyFriendly[yes], near[Raja Indian Cuisine]"	The Waterman is an italian restaurant located in the city centre near Raja Indian Cuisine. It is child friendly and has a high price range.
"name[The Waterman], eatType[restaurant], food[Italian], priceRange[high], area[riverside], familyFriendly[no], near[Raja Indian Cuisine]"	The Waterman is an italian restaurant near Raja Indian Cuisine in the riverside area. It is not child friendly and has a high price range.
"name[The Waterman], eatType[restaurant], food[Italian], priceRange[high], area[riverside], familyFriendly[yes], near[Raja Indian Cuisine]"	The Waterman is a child friendly italian restaurant near Raja Indian Cuisine in the riverside area. The price range is high.
"name[The Waterman], eatType[restaurant], food[Italian], priceRange[less than £20], area[city centre], familyFriendly[no], near[Raja Indian Cuisine]"	The Waterman is an italian restaurant located in the city centre near Raja Indian Cuisine. It is not family-friendly and has a price range of less than £20.
"name[The Waterman], eatType[restaurant], food[Italian], priceRange[less than £20], area[city centre], familyFriendly[yes], near[Raja Indian Cuisine]"	The Waterman is a family-friendly italian restaurant located in the city centre near Raja Indian Cuisine. It has a price range of less than £20.
"name[The Waterman], eatType[restaurant], food[Italian], priceRange[less than £20], area[riverside], familyFriendly[no], near[Raja Indian Cuisine]"	The Waterman is an italian restaurant located near Raja Indian Cuisine in the riverside area. It is not family-friendly and has a price range of less than £20.
"name[The Wrestlers], eatType[pub], food[Italian], priceRange[less than £20], area[riverside], familyFriendly[no], near[Raja Indian Cuisine]"	The Wrestlers is an italian pub located near Raja Indian Cuisine in the riverside area. It is not family-friendly and has a price range of less than £20.
"name[The Wrestlers], eatType[pub], food[Italian], priceRange[less than £20], area[riverside], familyFriendly[yes], near[Raja Indian Cuisine]"	The Wrestlers is a family friendly pub near Raja Indian Cuisine in the riverside area. It serves italian food for less than £20.
"name[The Wrestlers], eatType[pub], food[Italian], priceRange[moderate], area[city centre], familyFriendly[no], near[Raja Indian Cuisine]"	The Wrestlers is an italian pub located near Raja Indian Cuisine in the city centre. It is not kid friendly and has a moderate price range.
"name[The Wrestlers], eatType[pub], food[Italian], priceRange[moderate], area[city centre], familyFriendly[yes], near[Raja Indian Cuisine]"	The Wrestlers is a pub that serves italian food. It is located near Raja Indian Cuisine in the city centre. It is kid friendly and has a moderate price range.
"name[The Wrestlers], eatType[pub], food[Italian], priceRange[moderate], area[riverside], familyFriendly[no], near[Raja Indian Cuisine]"	The Wrestlers is an italian pub located near Raja Indian Cuisine in the riverside area. It is not kid friendly and has a moderate price range.
"name[The Wrestlers], eatType[pub], food[Italian], priceRange[moderate], area[riverside], familyFriendly[yes], near[Raja Indian Cuisine]"	The Wrestlers is a moderately priced pub near Raja Indian Cuisine. It is kid friendly and serves italian food.
"name[The Wrestlers], eatType[pub], food[Italian], priceRange[more than £30], area[riverside], familyFriendly[yes], near[Raja Indian Cuisine]"	The Wrestlers is an italian pub near Raja Indian Cuisine in the riverside area. It is child friendly and has a price range of more than £30.
"name[The Wrestlers], eatType[pub], food[Japanese], priceRange[£20-25], area[riverside], familyFriendly[yes], near[Raja Indian Cuisine]"	The Wrestlers is a kid friendly pub that serves japanese food. It is located near Raja Indian Cuisine in the riverside area and has a price range of £20-25.
"name[The Wrestlers], eatType[pub], food[Japanese], priceRange[cheap], area[riverside], familyFriendly[yes], near[Raja Indian Cuisine]"	"The Wrestlers is a cheap, family friendly pub that serves japanese food. It is located in the riverside area near Raja Indian Cuisine."
"name[The Wrestlers], eatType[pub], food[Japanese], priceRange[high], area[riverside], familyFriendly[yes], near[Raja Indian Cuisine]"	The Wrestlers is a high-priced pub near Raja Indian Cuisine. It is a child friendly pub.
"name[The Wrestlers], eatType[pub], food[Japanese], priceRange[less than £20], area[city centre], familyFriendly[no], near[Raja Indian Cuisine]"	The Wrestlers is a pub that serves japanese food. It is located near Raja Indian Cuisine in the city centre. It is not family-friendly and has a price range of less than £20.
"name[The Wrestlers], eatType[pub], food[Japanese], priceRange[less than £20], area[city centre], familyFriendly[yes], near[Raja Indian Cuisine]"	The Wrestlers is a family-friendly pub that serves japanese food. It is located in the city centre near Raja Indian Cuisine. It has a price range of less than £20.
"name[The Wrestlers], eatType[pub], food[Japanese], priceRange[less than £20], area[riverside], familyFriendly[no], near[Raja Indian Cuisine]"	The Wrestlers is a pub that serves japanese food for less than £20. It is located near Raja Indian Cuisine in the riverside area. It is not family-friendly.
"name[The Wrestlers], eatType[pub], food[Japanese], priceRange[less than £20], area[riverside], familyFriendly[yes], near[Raja Indian Cuisine]"	The Wrestlers is a family-friendly pub that serves japanese food. It is located near Raja Indian Cuisine in the riverside area and has a price range of less than £20.
"name[The Wrestlers], eatType[pub], food[Japanese], priceRange[moderate], area[city centre], familyFriendly[no], near[Raja Indian Cuisine]"	The Wrestlers is a pub that serves japanese food. It is located near Raja Indian Cuisine in the city centre. It is not kid friendly and has a moderate price range.
"name[The Wrestlers], eatType[pub], food[Japanese], priceRange[moderate], area[city centre], familyFriendly[yes], near[Raja Indian Cuisine]"	The Wrestlers is a pub that serves japanese food. It is located near Raja Indian Cuisine in the city centre. It is kid friendly and has a moderate price range.
"name[The Wrestlers], eatType[pub], food[Japanese], priceRange[moderate], area[riverside], familyFriendly[no], near[Raja Indian Cuisine]"	The Wrestlers is a pub that serves japanese food. It is located near Raja Indian Cuisine in the riverside area. It is not child friendly and has a moderate price range.
"name[The Wrestlers], eatType[pub], food[Japanese], priceRange[moderate], area[riverside], familyFriendly[yes], near[Raja Indian Cuisine]"	The Wrestlers is a kid friendly pub that serves japanese food. It is located near Raja Indian Cuisine in the riverside area and has a moderate price range.
"name[The Wrestlers], eatType[pub], food[Japanese], priceRange[moderate], customer rating[1 out of 5], area[city centre], familyFriendly[yes], near[Raja Indian Cuisine]"	The Wrestlers is a pub that serves japanese food. It is located in the city centre near Raja Indian Cuisine. It is kid friendly and has a customer rating of 1 out of 5.
"name[The Wrestlers], eatType[pub], food[Japanese], priceRange[moderate], customer rating[1 out of 5], area[riverside], familyFriendly[no], near[Raja Indian Cuisine]"	The Wrestlers is a pub that serves japanese food. It is located near Raja Indian Cuisine in the riverside area. It is not kid friendly and has a customer rating of 1 out of 5.
"name[The Wrestlers], eatType[pub], food[Japanese], priceRange[moderate], customer rating[1 out of 5], area[riverside], familyFriendly[yes], near[Raja Indian Cuisine]"	The Wrestlers is a pub that serves japanese food. It is located near Raja Indian Cuisine. It is kid friendly and has a customer rating of 1 out of 5 and is in the riverside area.
"name[The Wrestlers], eatType[pub], food[Japanese], priceRange[more than £30], area[city centre], familyFriendly[no], near[Raja Indian Cuisine]"	The Wrestlers is a pub that serves japanese food. It is located in the city centre near Raja Indian Cuisine. It is not child friendly and has a price range of more than £30.
"name[The Wrestlers], eatType[pub], food[Japanese], priceRange[more than £30], area[city centre], familyFriendly[yes], near[Raja Indian Cuisine]"	The Wrestlers is a pub that serves japanese food. It is located in the city centre near Raja Indian Cuisine. It is child friendly and has a price range of more than £30.
"name[The Wrestlers], eatType[pub], food[Japanese], priceRange[more than £30], area[riverside], familyFriendly[no], near[Raja Indian Cuisine]"	The Wrestlers is a japanese pub near Raja Indian Cuisine in the riverside area. It is not child friendly and has a price range of more than £30.
"name[The Wrestlers], eatType[pub], food[Japanese], priceRange[more than £30], area[riverside], familyFriendly[yes], near[Raja Indian Cuisine]"	The Wrestlers is a pub that serves japanese food. It is located near Raja Indian Cuisine in the riverside area. It is child friendly and has a price range of more than £30.
"name[The Wrestlers], eatType[pub], food[Japanese], priceRange[more than £30], customer rating[5 out of 5], area[city centre], familyFriendly[no], near[Raja Indian Cuisine]"	The Wrestlers is a highly rated pub in the city centre near Raja Indian Cuisine. It serves japanese food and is not child friendly. The price range is more than £30.
"name[The Wrestlers], eatType[pub], food[Japanese], priceRange[more than £30], customer rating[5 out of 5], area[city centre], familyFriendly[yes], near[Raja Indian Cuisine]"	The Wrestlers is a pub that serves japanese food. It is located near Raja Indian Cuisine in the city centre. It has a customer rating of 5 out of 5. It is a child-friendly pub with a price range of more than £30.
"name[The Wrestlers], eatType[pub], food[Japanese], priceRange[more than £30], customer rating[5 out of 5], area[riverside], familyFriendly[no], near[Raja Indian Cuisine]"	The Wrestlers is a pub that serves japanese food. It is located near Raja Indian Cuisine in the riverside area. It has a customer rating of 5 out of 5. It is not child friendly and has a price range of more than £30.
"name[The Wrestlers], eatType[pub], food[Japanese], priceRange[more than £30], customer rating[5 out of 5], area[riverside], familyFriendly[yes], near[Raja Indian Cuisine]"	The Wrestlers is a pub that serves japanese food. It is located near Raja Indian Cuisine in the riverside area. It has a customer rating of 5 out of 5 and is children friendly and has a price range of more than £30.
"name[The Wrestlers], eatType[pub], food[Japanese], priceRange[more than £30], customer rating[low], area[city centre], familyFriendly[no], near[Raja Indian Cuisine]"	The Wrestlers is a pub that serves japanese food. It is located near Raja Indian Cuisine in the city centre. It is not child friendly and has a low customer rating.
"name[The Wrestlers], eatType[pub], food[Japanese], priceRange[more than £30], customer rating[low], area[city centre], familyFriendly[yes], near[Raja Indian Cuisine]"	The Wrestlers is a pub that serves japanese food. It is located near Raja Indian Cuisine in the city centre. It has a low customer rating and a price range of more than £30. It is a pub type restaurant.
"name[The Wrestlers], eatType[pub], food[Japanese], priceRange[more than £30], customer rating[low], area[riverside], familyFriendly[no], near[Raja Indian Cuisine]"	The Wrestlers is a japanese pub near Raja Indian Cuisine in the riverside area. It is not child friendly and has a low customer rating and a price range of more than £30.
"name[The Wrestlers], eatType[pub], food[Japanese], priceRange[more than £30], customer rating[low], area[riverside], familyFriendly[yes], near[Raja Indian Cuisine]"	The Wrestlers is a pub that serves japanese food. It is located near Raja Indian Cuisine in the riverside area. It is children friendly and has a low customer rating and a price range of more than £30.
"name[The Wrestlers], eatType[restaurant], food[Italian], priceRange[less than £20], area[riverside], familyFriendly[no], near[Raja Indian Cuisine]"	The Wrestlers is an italian restaurant located near Raja Indian Cuisine in the riverside area. It is not family-friendly and has a price range of less than £20.
"name[The Wrestlers], eatType[restaurant], food[Italian], priceRange[less than £20], area[riverside], familyFriendly[yes], near[Raja Indian Cuisine]"	The Wrestlers is a family friendly italian restaurant located near Raja Indian Cuisine in the riverside area with a price range of less than £20.
"name[The Wrestlers], eatType[restaurant], food[Italian], priceRange[moderate], area[city centre], familyFriendly[no], near[Raja Indian Cuisine]"	The Wrestlers is an italian restaurant located near Raja Indian Cuisine in the city centre. It is not kid friendly and has a moderate price range.
"name[The Wrestlers], eatType[restaurant], food[Italian], priceRange[moderate], area[city centre], familyFriendly[yes], near[Raja Indian Cuisine]"	The Wrestlers is an italian restaurant located near Raja Indian Cuisine in the city centre. It is kid friendly and has a moderate price range.
"name[The Wrestlers], eatType[restaurant], food[Italian], priceRange[moderate], area[riverside], familyFriendly[no], near[Raja Indian Cuisine]"	The Wrestlers is an italian restaurant near Raja Indian Cuisine in the riverside area. It is not kid friendly and has a moderate price range.
"name[The Wrestlers], eatType[restaurant], food[Italian], priceRange[moderate], area[riverside], familyFriendly[yes], near[Raja Indian Cuisine]"	The Wrestlers is a moderately priced italian restaurant located near Raja Indian Cuisine in the riverside area.
"name[The Wrestlers], eatType[restaurant], food[Italian], priceRange[more than £30], area[riverside], familyFriendly[yes], near[Raja Indian Cuisine]"	The Wrestlers is an italian restaurant near Raja Indian Cuisine in the riverside area. It is children friendly and has a price range of more than £30.
"name[The Wrestlers], eatType[restaurant], food[Japanese], priceRange[£20-25], area[riverside], familyFriendly[yes], near[Raja Indian Cuisine]"	The Wrestlers is a japanese restaurant near Raja Indian Cuisine in the riverside area. It is kid friendly and has a price range of £20-25.
"name[The Wrestlers], eatType[restaurant], food[Japanese], priceRange[cheap], area[riverside], familyFriendly[yes], near[Raja Indian Cuisine]"	The Wrestlers is a cheap japanese restaurant near Raja Indian Cuisine in the riverside area. It is family friendly.
"name[The Wrestlers], eatType[restaurant], food[Japanese], priceRange[high], area[riverside], familyFriendly[yes], near[Raja Indian Cuisine]"	The Wrestlers is a japanese restaurant located near Raja Indian Cuisine in the riverside area. It is child friendly and has a high price range.
"name[The Wrestlers], eatType[restaurant], food[Japanese], priceRange[less than £20], area[city centre], familyFriendly[no], near[Raja Indian Cuisine]"	The Wrestlers is a japanese restaurant located in the city centre near Raja Indian Cuisine. It is not family-friendly and has a price range of less than £20.
"name[The Wrestlers], eatType[restaurant], food[Japanese], priceRange[less than £20], area[city centre], familyFriendly[yes], near[Raja Indian Cuisine]"	The Wrestlers is a family-friendly japanese restaurant located in the city centre near Raja Indian Cuisine with a price range less than £20.
"name[The Wrestlers], eatType[restaurant], food[Japanese], priceRange[less than £20], area[riverside], familyFriendly[no], near[Raja Indian Cuisine]"	The Wrestlers is a japanese restaurant located near Raja Indian Cuisine in the riverside area. It is not family-friendly and has a price range of less than £20.
"name[The Wrestlers], eatType[restaurant], food[Japanese], priceRange[less than £20], area[riverside], familyFriendly[yes], near[Raja Indian Cuisine]"	The Wrestlers is a family friendly japanese restaurant located near Raja Indian Cuisine in the riverside area with a price range of less than £20.
"name[The Wrestlers], eatType[restaurant], food[Japanese], priceRange[moderate], area[city centre], familyFriendly[no], near[Raja Indian Cuisine]"	The Wrestlers is a japanese restaurant located near Raja Indian Cuisine in the city centre. It is not kid friendly and has a moderate price range.
"name[The Wrestlers], eatType[restaurant], food[Japanese], priceRange[moderate], area[city centre], familyFriendly[yes], near[Raja Indian Cuisine]"	The Wrestlers is a kid-friendly japanese restaurant located in the city centre near Raja Indian Cuisine. It has a moderate price range.
"name[The Wrestlers], eatType[restaurant], food[Japanese], priceRange[moderate], area[riverside], familyFriendly[no], near[Raja Indian Cuisine]"	The Wrestlers is a japanese restaurant located near Raja Indian Cuisine in the riverside area. It is not kid friendly and has a moderate price range.
"name[The Wrestlers], eatType[restaurant], food[Japanese], priceRange[moderate], area[riverside], familyFriendly[yes], near[Raja Indian Cuisine]"	The Wrestlers is a kid friendly japanese restaurant located near Raja Indian Cuisine in the riverside area. It has a moderate price range.
"name[The Wrestlers], eatType[restaurant], food[Japanese], priceRange[more than £30], area[city centre], familyFriendly[no], near[Raja Indian Cuisine]"	The Wrestlers is a japanese restaurant located in the city centre near Raja Indian Cuisine. It is not child friendly and has a price range of more than £30.
"name[The Wrestlers], eatType[restaurant], food[Japanese], priceRange[more than £30], area[city centre], familyFriendly[yes], near[Raja Indian Cuisine]"	The Wrestlers is a japanese restaurant located in the city centre near Raja Indian Cuisine. It is children friendly and has a price range of more than £30.
"name[The Wrestlers], eatType[restaurant], food[Japanese], priceRange[more than £30], area[riverside], familyFriendly[no], near[Raja Indian Cuisine]"	The Wrestlers is a japanese restaurant located near Raja Indian Cuisine in the riverside area. It is not child friendly and has a price range of more than £30.
"name[The Wrestlers], eatType[restaurant], food[Japanese], priceRange[more than £30], area[riverside], familyFriendly[yes], near[Raja Indian Cuisine]"	The Wrestlers is a japanese restaurant located near Raja Indian Cuisine in the riverside area. It is child friendly and has a price range of more than £30.
"name[Wildwood], eatType[coffee shop], area[riverside]"	Wildwood is a coffee shop in the riverside area.
"name[Wildwood], eatType[pub], area[riverside]"	There is a pub in the riverside area called Wildwood.
"name[Wildwood], eatType[pub], food[French], area[riverside], familyFriendly[yes], near[Raja Indian Cuisine]"	Wildwood is a family-friendly pub that serves french food. It is located in the riverside area near Raja Indian Cuisine.
"name[Wildwood], eatType[pub], food[Indian], area[city centre], familyFriendly[no], near[Raja Indian Cuisine]"	Wildwood is a pub that serves indian food. It is located in the city centre near Raja Indian Cuisine. It is not family friendly.
"name[Wildwood], eatType[pub], food[Indian], area[city centre], familyFriendly[yes], near[Raja Indian Cuisine]"	Wildwood is a family friendly pub that serves indian food. It is located in the city centre near Raja Indian Cuisine.
"name[Wildwood], eatType[pub], food[Indian], area[riverside], familyFriendly[no], near[Raja Indian Cuisine]"	Wildwood is a pub that serves indian food. It is located in the riverside area near Raja Indian Cuisine. It is not family friendly.
"name[Wildwood], eatType[pub], food[Indian], area[riverside], familyFriendly[yes], near[Raja Indian Cuisine]"	Wildwood is a family friendly pub that serves indian food. It is located in the riverside area near Raja Indian Cuisine.
"name[Wildwood], eatType[pub], food[Italian], area[city centre], familyFriendly[no], near[Raja Indian Cuisine]"	Wildwood is an italian pub located in the city centre near Raja Indian Cuisine. It is not family-friendly.
"name[Wildwood], eatType[pub], food[Italian], area[city centre], familyFriendly[yes], near[Raja Indian Cuisine]"	Wildwood is a family-friendly italian pub located in the city centre near Raja Indian Cuisine.
"name[Wildwood], eatType[pub], food[Italian], area[riverside], familyFriendly[no], near[Raja Indian Cuisine]"	Wildwood is an italian pub located near Raja Indian Cuisine in the riverside area. It is not family-friendly.
"name[Wildwood], eatType[pub], food[Italian], area[riverside], familyFriendly[yes], near[Raja Indian Cuisine]"	Wildwood is a family-friendly pub near Raja Indian Cuisine in the riverside area.
"name[Wildwood], eatType[restaurant], food[French], area[riverside], familyFriendly[yes], near[Raja Indian Cuisine]"	Wildwood is a family friendly french restaurant located near Raja Indian Cuisine in the riverside area.
"name[Wildwood], eatType[restaurant], food[Indian], area[city centre], familyFriendly[no], near[Raja Indian Cuisine]"	Wildwood is an indian restaurant located in the city centre near Raja Indian Cuisine. It is not family friendly.
"name[Wildwood], eatType[restaurant], food[Indian], area[city centre], familyFriendly[yes], near[Raja Indian Cuisine]"	Wildwood is an indian restaurant located in the city centre near Raja Indian Cuisine. It is family friendly.
"name[Wildwood], eatType[restaurant], food[Indian], area[riverside], familyFriendly[no], near[Raja Indian Cuisine]"	Wildwood is an indian restaurant located in the riverside area near Raja Indian Cuisine. It is not family friendly.
"name[Wildwood], eatType[restaurant], food[Indian], area[riverside], familyFriendly[yes], near[Raja Indian Cuisine]"	Wildwood is a family friendly indian restaurant located in the riverside area near Raja Indian Cuisine.
"name[Wildwood], eatType[restaurant], food[Italian], area[city centre], familyFriendly[no], near[Raja Indian Cuisine]"	Wildwood is an italian restaurant located in the city centre near Raja Indian Cuisine. It is not family-friendly.
"name[Wildwood], eatType[restaurant], food[Italian], area[city centre], familyFriendly[yes], near[Raja Indian Cuisine]"	Wildwood is a family-friendly italian restaurant located in the city centre near Raja Indian Cuisine.
"name[Wildwood], eatType[restaurant], food[Italian], area[riverside], familyFriendly[no], near[Raja Indian Cuisine]"	Wildwood is an italian restaurant located in the riverside area near Raja Indian Cuisine. It is not family-friendly.
"name[Wildwood], eatType[restaurant], food[Italian], area[riverside], familyFriendly[yes], near[Raja Indian Cuisine]"	Wildwood is a family-friendly italian restaurant located near Raja Indian Cuisine in the riverside area.
"name[Zizzi], eatType[coffee shop], area[riverside]"	Zizzi is a coffee shop in the riverside area.
"name[Zizzi], eatType[coffee shop], customer rating[average], near[Burger King]"	Zizzi is a coffee shop near Burger King. It has an average customer rating.
"name[Zizzi], eatType[coffee shop], customer rating[high], near[Burger King]"	Zizzi is a coffee shop near Burger King with a high customer rating.
"name[Zizzi], eatType[coffee shop], near[The Sorrento]"	Near The Sorrento is a coffee shop called Zizzi.
"name[Zizzi], eatType[pub], area[riverside]"	There is a pub in the riverside area called Zizzi.
"name[Zizzi], eatType[pub], customer rating[average], near[Burger King]"	Zizzi is a pub near Burger King with an average customer rating.
"name[Zizzi], eatType[pub], customer rating[high], near[Burger King]"	Zizzi is a pub near Burger King with a high customer rating.
"name[Zizzi], eatType[pub], near[The Sorrento]"	Near The Sorrento is a pub called Zizzi.
